key	text	tooltip
#Loc PackedFile;1;text/db/@custom_land_units.loc		
land_units_onscreen_name_dan_anglian_marauders	Svear Vikingar	true
land_units_onscreen_name_sw_dan_vikingar	Danskir Vikingar	true
land_units_onscreen_name_dan_axemen	Danelaw Axeband	true
land_units_onscreen_name_dan_berserkers	Berserkir	true
land_units_onscreen_name_dan_ceorl_axemen	Danskir Holumenn	true
land_units_onscreen_name_dan_ceorl_javelinmen	Ruffians	true
land_units_onscreen_name_sw_dan_leidang	Leidang Spearband	true
land_units_onscreen_name_dan_fyrd_archers	Bandits	true
land_units_onscreen_name_dan_huscarls	Danskir Storroxar	true
land_units_onscreen_name_dan_jarls_huscarls	Silver Wolves	true
land_units_onscreen_name_dan_javelinmen	Danelaw Skirmishers	true
land_units_onscreen_name_dan_mailed_horsemen	Frankish Horsemen	true
land_units_onscreen_name_dan_mailed_swordsmen	Sverddani	true
land_units_onscreen_name_dan_northumbrian_mailed_thegns	Frisian Mercenaries	true
land_units_onscreen_name_sw_dan_elite_general	Danskir Huskarlar	true
land_units_onscreen_name_dan_shield_biters	Danskir Sea Captain	true
land_units_onscreen_name_sw_dan_danelaw_spears	Danelaw Spearband	true
land_units_onscreen_name_dan_sword_hersir	Anglian Thegns	true
land_units_onscreen_name_dan_sword_hirdmen	Hirdmenn Swordband	true
land_units_onscreen_name_sw_dan_general	Danskir Hirdmenn	true
land_units_onscreen_name_sw_eng_gebur_bow	Gebur Bowmen	true
land_units_onscreen_name_sw_eng_gebur_axe	Gebur Axeband	true
land_units_onscreen_name_sw_eng_gebur_skirm	Gebur Skirmishers	true
land_units_onscreen_name_sw_eng_gebur_spear	Gebur Spearband	true
land_units_onscreen_name_sw_eng_thegn_mounted	Thegn Horsemen	true
land_units_onscreen_name_eng_earls_spearmen	Gedriht Spearband	true
land_units_onscreen_name_eng_earls_thegns	Gedriht Swordband	true
land_units_onscreen_name_sw_eng_ceorl_axe	Ceorl Axeband	true
land_units_onscreen_name_sw_eng_ceorl_skirm	Ceorl Skirmishers	true
land_units_onscreen_name_sw_eng_fyrd_spear	Fyrd Spearband	true
land_units_onscreen_name_sw_eng_butsecarl	Butsecarls	true
land_units_onscreen_name_eng_mailed_horsemen	Marcher Horsemen	true
land_units_onscreen_name_eng_mailed_seaxs	Seax Warband	true
land_units_onscreen_name_eng_mailed_thegns	Old Captain	true
land_units_onscreen_name_eng_marcher_armoured_spearmen	Sons of Fhionghuin	true
land_units_onscreen_name_eng_marcher_spearmen	Marcher Spearband	true
land_units_onscreen_name_eng_militia_fyrd_archers	Marcher Archers	true
land_units_onscreen_name_sw_eng_general	Hearrthweru	true
land_units_onscreen_name_sw_eng_elite_general	Huscarlas	true
land_units_onscreen_name_sw_eng_wessex_hero	Gedriht Swordband	true
land_units_onscreen_name_sw_eng_seax	Geoguth Warband	true
land_units_onscreen_name_sw_eng_select_fyrd_spear	Select Fyrd Spearband	true
land_units_onscreen_name_sw_eng_select_fyrd_mounted	Select Fyrd Horsemen	true
land_units_onscreen_name_sw_eng_thegn_spear	Thegn Spearband	true
land_units_onscreen_name_sw_eng_thegn_sword	Thegn Swordband	true
land_units_onscreen_name_sw_est_longbowmen	Langbogamenn	true
land_units_onscreen_name_est_axe_warriors	Austmenn Vikingar	true
land_units_onscreen_name_sw_est_karl_axe	Karl Axeband	true
land_units_onscreen_name_est_berserkers	Nordmenn Sea Captain	true
land_units_onscreen_name_sw_est_hero_nordmenn_sea_king	Nordmenn Saekonungr	true
land_units_onscreen_name_est_fighters	Brigands	true
land_units_onscreen_name_sw_est_general	Norronir Hirdmenn	true
land_units_onscreen_name_est_est_hirdmenn_sword	Hirdmenn Swordband	true
land_units_onscreen_name_sw_est_hunters	Veidrmenn	true
land_units_onscreen_name_sw_est_skirmisher	Vestmenn Skirmishers	true
land_units_onscreen_name_sw_est_long_axes	Nordmenn Langoxar	true
land_units_onscreen_name_sw_est_hirdmenn_axe	Hirdmenn Axeband	true
land_units_onscreen_name_est_mailed_horsemen	Reavers	true
land_units_onscreen_name_sw_est_sailors	Nordmenn Holumenn	true
land_units_onscreen_name_sw_est_rekkar	Rekkar Swordband	true
land_units_onscreen_name_est_norse_mailed_hersir	Austmenn Saekonungr	true
land_units_onscreen_name_sw_est_drengir	Drengir Band	true
land_units_onscreen_name_sw_est_elite_general	Norronir Huskarlar	true
land_units_onscreen_name_sw_est_scout	Nordmenn Ridari	true
land_units_onscreen_name_sw_est_hero_shield_biter	Ulfhednar	true
land_units_onscreen_name_sw_est_hirdmenn_spear	Hirdmenn Spearband	true
land_units_onscreen_name_sw_est_nordmenn_vikingar	Nordmenn Vikingar	true
land_units_onscreen_name_sw_est_karl_spear	Karl Spearband	true
land_units_onscreen_name_est_warband	Thrall Spearband	true
land_units_onscreen_name_iri_airig_horsemen	Boairi Horsemen	true
land_units_onscreen_name_iri_airig_mailed_horsemen	Airig Horsmen	true
land_units_onscreen_name_iri_airig_swordsmen	Deaisbard	true
land_units_onscreen_name_iri_airig_warband	Airig Swordband	true
land_units_onscreen_name_iri_foreign_warriors	Tuagh Catha Warband	true
land_units_onscreen_name_iri_freemen_axemen	Bothacha Axeband	true
land_units_onscreen_name_iri_freemen_spearmen	Bothacha Spearband	true
land_units_onscreen_name_iri_household_horsemen	Deaisbard	true
land_units_onscreen_name_iri_household_riders	Riglach	true
land_units_onscreen_name_iri_kern_axemen	Ceithrenn Axeband	true
land_units_onscreen_name_iri_kern_raiders	Scout Horsemen	true
land_units_onscreen_name_iri_kern_spearmen	Ceithrenn Spearband	true
land_units_onscreen_name_iri_kerns	Ceithrenn Skirmishers	true
land_units_onscreen_name_iri_mailed_fianna	Caur (Champion)	true
land_units_onscreen_name_iri_serf_archers	Bogclochdair (Slingers) 	true
land_units_onscreen_name_iri_spear_raiders	Airig Spearband	true
land_units_onscreen_name_iri_wood_kerns	Ceithrenn Coille	true
land_units_onscreen_name_nor_axe_levy	Militia Axeband	true
land_units_onscreen_name_nor_axemen	Breton Axeband	true
land_units_onscreen_name_nor_cavalry	Serjeant Horsemen	true
land_units_onscreen_name_nor_foot_soldiers	Miles Swordband	true
land_units_onscreen_name_nor_horsemen	Breton Horsemen	true
land_units_onscreen_name_nor_levy_archers	Militia Bowmen	true
land_units_onscreen_name_nor_levy_spearmen	Militia Spearband	true
land_units_onscreen_name_nor_mailed_spearmen	Serjeant Spearband	true
land_units_onscreen_name_nor_maine_warriors	Maine Swordband	true
land_units_onscreen_name_nor_miles	Familia Regis	true
land_units_onscreen_name_nor_scout_cavalry	Norman Squires	true
land_units_onscreen_name_nor_shield_wall	Flemish Spearband	true
land_units_onscreen_name_nor_spearmen	Pedes Spearband	true
land_units_onscreen_name_nor_swordsmen	Serjeant Swordband	true
land_units_onscreen_name_sco_alban_crossbowmen	Sasannaich Crossbowmen	true
land_units_onscreen_name_sco_alban_levy_javelinmen	Albannaich Skirmishers	true
land_units_onscreen_name_sco_alban_levy_spearmen	Sasannaich Spearband	true
land_units_onscreen_name_sco_alban_spearmen	Gaidheil Spearband	true
land_units_onscreen_name_sco_alban_warriors	Gaiscedach Cland	true
land_units_onscreen_name_sco_cateran_axemen	Gaidheil Axeband	true
land_units_onscreen_name_sco_cateran_levy	Sasannaich Axeband	true
land_units_onscreen_name_sco_highland_archers	Gaidheil Archers	true
land_units_onscreen_name_sco_kings_blades	Teglach Band	true
land_units_onscreen_name_sco_lowland_crossbowmen	Teglach Crossbowmen	true
land_units_onscreen_name_sco_lowland_raiders	Scout Riders	true
land_units_onscreen_name_sco_mormaer_horsemen	Reiver Horsemen	true
land_units_onscreen_name_sco_royal_bodyguard	Teglach Horsemen	true
land_units_onscreen_name_sco_royal_cavalry	Toisech Horsemen	true
land_units_onscreen_name_sco_schiltron	Albannaich Long Spears	true
land_units_onscreen_name_sco_sword_band	Claideb Dubh	true
land_units_onscreen_name_sco_sword_warriors	Sons of Grigoir	true
land_units_onscreen_name_vik_archers	Langbogamenn	true
land_units_onscreen_name_vik_axe_freemen	Karl Axeband	true
land_units_onscreen_name_vik_axe_hirdmen	Hirdmenn Axeband	true
land_units_onscreen_name_vik_freemen	Karl Spearband	true
land_units_onscreen_name_vik_hearthguard	Norronir Hirdmenn	true
land_units_onscreen_name_vik_hunters	Veidrmenn	true
land_units_onscreen_name_vik_jomsvikings	Jomsvikingar	true
land_units_onscreen_name_vik_long_axes	Nordmenn Langoxar	true
land_units_onscreen_name_sw_est_bow_warrior	Bogadrengir	true
land_units_onscreen_name_vik_mailed_hersir_axemen	Nordmenn Saekonungr	true
land_units_onscreen_name_vik_mailed_hersir_swordsmen	Hirdmenn Swordband	true
land_units_onscreen_name_vik_royal_huskarls	Norronir Huskarlar	true
land_units_onscreen_name_vik_scouts	Nordmenn Ridari	true
land_units_onscreen_name_vik_shield_biters	Ulfhednar	true
land_units_onscreen_name_vik_skirmishers	Thrall Skirmishers	true
land_units_onscreen_name_vik_spear_hersir	Hirdmenn Spearband	true
land_units_onscreen_name_vik_spear_hirdmen	Nordmenn Vikingar	true
land_units_onscreen_name_vik_sword_hersir	Rekkar Swordband	true
land_units_onscreen_name_vik_sword_hirdmen	Drengir Band	true
land_units_onscreen_name_vik_thrall_axemen	Holumenn (Sailors)	true
land_units_onscreen_name_vik_thrall_spearmen	Thrall Spearband	true
land_units_onscreen_name_sw_wel_archers	Saethydd	true
land_units_onscreen_name_wel_armoured_axemen	Highwaymen	true
land_units_onscreen_name_sw_wel_gwrda_sword	Gwrda Swordband	true
land_units_onscreen_name_sw_wel_cadwr_axe	Cadwr Axeband	true
land_units_onscreen_name_sw_wel_cambrogi	Combrogi Horsemen	true
land_units_onscreen_name_sw_wel_longbow_hero	Haelwyd Longbows	true
land_units_onscreen_name_sw_wel_taeog_axe	Taeog Axeband	true
land_units_onscreen_name_sw_wel_skirmisher	Taeog Skirmishers	true
land_units_onscreen_name_sw_wel_taeog_spear	Taeog Band	true
land_units_onscreen_name_sw_wel_longbowmen	Combrogi Longbowmen	true
land_units_onscreen_name_sw_wel_teulu_sword	Teulu Swordband	true
land_units_onscreen_name_sw_wel_strat_clut_comites	Hen Ogledd Comites	true
land_units_onscreen_name_sw_wel_uchelwr_spear	Uchelwr Spearband	true
land_units_onscreen_name_sw_wel_elite_general	Teulu Horsemen	true
land_units_onscreen_name_sw_wel_penteulu_hero	Penteulu	true
land_units_onscreen_name_sw_wel_scout	Sgowt Horsemen	true
land_units_onscreen_name_sw_wel_pedyt_spear	Pedyt Spearband	true
land_units_onscreen_name_sw_wel_young_sword	Young Swords	true
land_units_onscreen_name_sw_wel_general	Teulu Riders	true
land_units_onscreen_name_sw_wel_teulu_spear	Teulu Spearband	true
land_units_onscreen_name_sw_wel_uchelwr_mounted	Uchelwr Horsemen	true
land_units_onscreen_name_wel_valley_spearmen	Footpads	true
land_units_onscreen_name_sw_mrc_vikingar	Vikingar	true
land_units_onscreen_name_dan_ceorl_archers	Veidrmenn (Hunters)	true
land_units_onscreen_name_sw_eng_fyrd_bow	Fyrd Bowman	true
land_units_onscreen_name_sw_eng_scout	Scout Horsemen	true
land_units_onscreen_name_sw_eng_select_fyrd_bow	Select Fyrd Archers	true
land_units_onscreen_name_sw_wel_hunters	Helwyr	true
