key	text	tooltip
#Loc PackedFile;1;text/db/factions.loc		
factions_attack_desc_vik_fact_airer_goidel	You are attacking Airer Goidel	true
factions_screen_name_when_rebels_vik_fact_east_seaxe	East Seaxe Rebels	true
factions_clan_summary_name_when_shogun_vik_fact_separatists_gwined	placeholder	true
factions_senator_text_gain_n_vik_fact_jorvik	%n of %n Nobles	true
factions_screen_name_vik_fact_brega	Brega	true
factions_senator_text_gain_n_vik_fact_rebels_english	%n of %n Nobles	true
factions_senator_text_gain_1_vik_fact_rebels_english	%n of %n Nobles	true
factions_clan_summary_name_vik_fact_gliwissig	placeholder	true
factions_senator_text_gain_1_vik_fact_jorvik	%n of %n Nobles	true
factions_screen_adjective_vik_fact_caisil_usurpers	Caisil	true
factions_screen_adjective_vik_fact_rebels_scottish	Scottish Rebels	true
factions_defend_desc_att_fact_blue	Red	true
factions_screen_adjective_vik_fact_grantebru	Grantebru	true
factions_senator_text_n_out_of_n_vik_fact_separatists_dyflin	%n of %n Nobles	true
factions_screen_adjective_vik_fact_aileach	Ailech	true
factions_senator_text_n_out_of_n_vik_fact_brechinauc	%n of %n Nobles	true
factions_senator_text_gain_n_vik_fact_gwined	%n of %n Nobles	true
factions_senator_text_gain_1_vik_fact_gwined	%n of %n Nobles	true
factions_defend_desc_vik_fact_separatists_east_engle	You are defending against East Engle Usurpers	true
factions_clan_summary_name_when_shogun_vik_fact_strat_clut	placeholder	true
factions_senator_text_lose_n_vik_fact_rebels_irish	%n of %n Nobles	true
factions_senator_text_lose_1_vik_fact_rebels_irish	%n of %n Nobles	true
factions_senator_text_lose_n_vik_fact_defena	%n of %n Nobles	true
factions_clan_summary_name_when_shogun_vik_fact_mide	placeholder	true
factions_senator_text_lose_n_vik_fact_caisil	%n of %n Nobles	true
factions_defend_desc_vik_fact_rebels_viking	You are defending against Viking Rebels	true
factions_senator_text_n_out_of_n_vik_fact_separatists_mierce	%n of %n Nobles	true
factions_attack_desc_vik_fact_separatists_sudreyar	You are attacking Sudreyar Usurpers	true
factions_senator_text_lose_n_vik_fact_rebels_welsh	%n of %n Nobles	true
factions_senator_text_lose_1_vik_fact_rebels_welsh	%n of %n Nobles	true
factions_screen_name_vik_fact_dyfet	Dewet	true
factions_screen_name_when_rebels_vik_fact_veisafjordr	Veisafjordr Rebels	true
factions_screen_name_when_rebels_vik_fact_vedrafjordr	Vedrafjordr Rebels	true
factions_screen_name_when_shogun_vik_fact_separatists_circenn	placeholder	true
factions_clan_summary_name_vik_fact_grantebru	placeholder	true
factions_screen_name_when_shogun_vik_fact_hellirborg_usurpers	placeholder	true
factions_defend_desc_vik_fact_fortriu	You are defending against Fortriu	true
factions_screen_name_vik_fact_osraige	Osraige	true
factions_senator_text_lose_1_vik_fact_caisil	%n of %n Nobles	true
factions_screen_adjective_vik_fact_northleode	Northanhymbra	true
factions_senator_text_lose_1_vik_fact_defena	%n of %n Nobles	true
factions_attack_desc_vik_fact_osraige	You are attacking Osraige	true
factions_senator_text_gain_n_vik_fact_separatists_strat_clut	%n of %n Nobles	true
factions_screen_adjective_vik_fact_gliwissig	Gliwissig	true
factions_senator_text_lose_1_vik_fact_veisafjordr	%n of %n Nobles	true
factions_screen_adjective_vik_fact_desmuma	Desmuma	true
factions_senator_text_lose_1_vik_fact_vedrafjordr	%n of %n Nobles	true
factions_senator_text_lose_n_att_fact_yellow	%n of %n Nobles	true
factions_senator_text_lose_n_vik_fact_hwicce	%n of %n Nobles	true
factions_clan_summary_name_when_shogun_vik_fact_hellirborg	placeholder	true
factions_senator_text_gain_1_vik_fact_separatists_strat_clut	%n of %n Nobles	true
factions_senator_text_lose_1_vik_fact_hwicce	%n of %n Nobles	true
factions_defend_desc_vik_fact_circenn	You are defending against Circenn	true
factions_senator_text_lose_1_att_fact_yellow	%n of %n Nobles	true
factions_attack_desc_vik_fact_bandits	You are attacking Bandits	true
factions_screen_name_vik_fact_bandits	Bandits	true
factions_defend_desc_vik_fact_airer_goidel	You are defending against Airer Goidel	true
factions_senator_text_n_out_of_n_vik_fact_seisilwig_usurpers	%n of %n Nobles	true
factions_defend_desc_vik_fact_separatists_west_seaxe	You are defending against West Seaxe Usurpers	true
factions_attack_desc_vik_fact_norse	You are attacking Norse	true
factions_clan_summary_name_when_shogun_vik_fact_northymbre	placeholder	true
factions_clan_summary_name_vik_fact_seisilwig	placeholder	true
factions_screen_name_when_rebels_vik_fact_northleode_usurpers	Northanhymbran Rebels	true
factions_attack_desc_att_fact_blue	Red	true
factions_senator_text_lose_1_vik_fact_northleode_usurpers	%n of %n Nobles	true
factions_senator_text_lose_n_vik_fact_haeden	%n of %n Nobles	true
factions_senator_text_gain_n_vik_fact_separatists_northymbre	%n of %n Nobles	true
factions_senator_text_lose_n_vik_fact_dyflin	%n of %n Nobles	true
factions_screen_adjective_vik_fact_hlymrekr_usurpers	Hlymrekr	true
factions_senator_text_gain_n_vik_fact_cerneu	%n of %n Nobles	true
factions_senator_text_gain_n_vik_fact_djurby	%n of %n Nobles	true
factions_senator_text_gain_1_vik_fact_djurby	%n of %n Nobles	true
factions_senator_text_gain_1_vik_fact_cerneu	%n of %n Nobles	true
factions_senator_text_lose_1_vik_fact_dyflin	%n of %n Nobles	true
factions_screen_adjective_vik_fact_gallgoidel	Gallgoidel	true
factions_senator_text_gain_1_vik_fact_separatists_northymbre	%n of %n Nobles	true
factions_senator_text_lose_1_vik_fact_haeden	%n of %n Nobles	true
factions_senator_text_gain_n_vik_fact_laigin	%n of %n Nobles	true
factions_clan_summary_name_when_shogun_vik_fact_westmoringas	placeholder	true
factions_senator_text_lose_n_vik_fact_mierce	%n of %n Nobles	true
factions_defend_desc_vik_fact_separatists_sudreyar	You are defending against Sudreyar Usurpers	true
factions_clan_summary_name_vik_fact_hlymrekr_usurpers	placeholder	true
factions_senator_text_lose_1_vik_fact_mierce	%n of %n Nobles	true
factions_senator_text_gain_1_vik_fact_laigin	%n of %n Nobles	true
factions_screen_adjective_vik_fact_seisilwig	Seisilwig	true
factions_screen_adjective_vik_fact_iarmuma	Iarmuma	true
factions_clan_summary_name_vik_fact_wicing	placeholder	true
factions_senator_text_gain_1_vik_fact_separatists_english	%n of %n Nobles	true
factions_senator_text_lose_n_vik_fact_separatists_strat_clut	%n of %n Nobles	true
factions_screen_adjective_vik_fact_westernas	Westernas	true
factions_senator_text_gain_n_att_fact_yellow	%n of %n Nobles	true
factions_clan_summary_name_when_shogun_vik_fact_dene	placeholder	true
factions_clan_summary_name_when_shogun_vik_fact_cent	placeholder	true
factions_senator_text_gain_n_vik_fact_hwicce	%n of %n Nobles	true
factions_screen_name_when_rebels_vik_fact_separatists_english	English Usurpers	true
factions_senator_text_lose_1_vik_fact_separatists_strat_clut	%n of %n Nobles	true
factions_senator_text_gain_1_vik_fact_hwicce	%n of %n Nobles	true
factions_clan_summary_name_vik_fact_veidrborg	placeholder	true
factions_defend_desc_vik_fact_iarmuma	You are defending against Iarmuma	true
factions_senator_text_gain_1_att_fact_yellow	%n of %n Nobles	true
factions_senator_text_gain_n_vik_fact_caisil	%n of %n Nobles	true
factions_senator_text_gain_n_vik_fact_defena	%n of %n Nobles	true
factions_senator_text_lose_1_vik_fact_separatists_english	%n of %n Nobles	true
factions_screen_name_vik_fact_gwent	Gwent	true
factions_clan_summary_name_vik_fact_holdrness	placeholder	true
factions_senator_text_gain_1_vik_fact_defena	%n of %n Nobles	true
factions_senator_text_gain_1_vik_fact_caisil	%n of %n Nobles	true
factions_clan_summary_name_when_shogun_vik_fact_seisilwig_usurpers	placeholder	true
factions_screen_adjective_vik_fact_holdrness	Holdrness	true
factions_screen_name_when_shogun_vik_fact_west_seaxe	placeholder	true
factions_senator_text_lose_n_vik_fact_gwined	%n of %n Nobles	true
factions_attack_desc_vik_fact_rebels_viking	You are attacking Viking Rebels	true
factions_senator_text_n_out_of_n_vik_fact_northymbre	%n of %n Nobles	true
factions_screen_name_vik_fact_breifne	Breifne	true
factions_attack_desc_vik_fact_breifne	You are attacking Breifne	true
factions_screen_adjective_vik_fact_separatists_viking	Viking Usurpers	true
factions_senator_text_lose_1_vik_fact_gwined	%n of %n Nobles	true
factions_senator_text_gain_1_vik_fact_northleode_usurpers	%n of %n Nobles	true
factions_senator_text_n_out_of_n_vik_fact_separatists_welsh	%n of %n Nobles	true
factions_screen_name_att_fact_blue	Red	true
factions_senator_text_n_out_of_n_vik_fact_separatists_irish	%n of %n Nobles	true
factions_screen_adjective_vik_fact_veidrborg	Veidrborg	true
factions_senator_text_lose_n_vik_fact_jorvik	%n of %n Nobles	true
factions_senator_text_lose_n_vik_fact_rebels_english	%n of %n Nobles	true
factions_senator_text_lose_1_vik_fact_rebels_english	%n of %n Nobles	true
factions_clan_summary_name_vik_fact_westernas	placeholder	true
factions_senator_text_lose_1_vik_fact_jorvik	%n of %n Nobles	true
factions_screen_name_when_shogun_vik_fact_east_engle	placeholder	true
factions_senator_text_n_out_of_n_vik_fact_strat_clut	%n of %n Nobles	true
factions_screen_name_vik_fact_separatists_sudreyar	Sudreyar Usurpers	true
factions_screen_adjective_vik_fact_circenn	Circenn	true
factions_screen_name_when_shogun_vik_fact_separatists_welsh	placeholder	true
factions_screen_name_when_shogun_vik_fact_separatists_irish	placeholder	true
factions_defend_desc_vik_fact_norse	You are defending against Norse	true
factions_clan_summary_name_when_shogun_vik_fact_separatists_mierce	placeholder	true
factions_defend_desc_vik_fact_desmuma	You are defending against Desmuma	true
factions_clan_summary_name_when_shogun_vik_fact_separatists_scottish	placeholder	true
factions_senator_text_gain_n_vik_fact_mierce	%n of %n Nobles	true
factions_senator_text_lose_n_vik_fact_laigin	%n of %n Nobles	true
factions_screen_adjective_vik_fact_fortriu	Fortriu	true
factions_senator_text_gain_1_vik_fact_vedrafjordr	%n of %n Nobles	true
factions_senator_text_n_out_of_n_vik_fact_hellirborg	%n of %n Nobles	true
factions_senator_text_gain_1_vik_fact_veisafjordr	%n of %n Nobles	true
factions_senator_text_lose_1_vik_fact_laigin	%n of %n Nobles	true
factions_senator_text_gain_1_vik_fact_mierce	%n of %n Nobles	true
factions_screen_name_when_shogun_vik_fact_suth_seaxe	placeholder	true
factions_screen_name_vik_fact_airer_goidel	Airer Goidel	true
factions_senator_text_lose_n_vik_fact_separatists_northymbre	%n of %n Nobles	true
factions_senator_text_gain_n_vik_fact_haeden	%n of %n Nobles	true
factions_screen_name_when_rebels_vik_fact_separatists_irish	Irish Usurpers	true
factions_senator_text_n_out_of_n_vik_fact_separatists_gwined	%n of %n Nobles	true
factions_screen_name_vik_fact_powis	Powis	true
factions_senator_text_lose_n_vik_fact_djurby	%n of %n Nobles	true
factions_senator_text_lose_n_vik_fact_cerneu	%n of %n Nobles	true
factions_screen_name_when_rebels_vik_fact_separatists_welsh	Welsh Usurpers	true
factions_senator_text_gain_n_vik_fact_dyflin	%n of %n Nobles	true
factions_screen_name_vik_fact_ulaid	Ulaid	true
factions_defend_desc_vik_fact_rebels_scottish	You are defending against Scottish Rebels	true
factions_defend_desc_vik_fact_caisil_usurpers	You are defending against Caisil Usurpers	true
factions_screen_name_when_shogun_vik_fact_heimiliborg	placeholder	true
factions_senator_text_gain_1_vik_fact_dyflin	%n of %n Nobles	true
factions_defend_desc_vik_fact_aileach	You are defending against Ailech	true
factions_senator_text_lose_1_vik_fact_cerneu	%n of %n Nobles	true
factions_senator_text_lose_1_vik_fact_djurby	%n of %n Nobles	true
factions_senator_text_gain_1_vik_fact_haeden	%n of %n Nobles	true
factions_senator_text_lose_1_vik_fact_separatists_northymbre	%n of %n Nobles	true
factions_clan_summary_name_when_shogun_vik_fact_separatists_dyflin	placeholder	true
factions_clan_summary_name_vik_fact_cumbra	placeholder	true
factions_clan_summary_name_when_shogun_vik_fact_brechinauc	placeholder	true
factions_screen_name_when_shogun_att_fact_red	placeholder	true
factions_screen_adjective_vik_fact_steinnborg	Steinnborg	true
factions_attack_desc_vik_fact_westmoringas	You are attacking Westmoringas	true
factions_defend_desc_vik_fact_mide	You are defending against Mide	true
factions_screen_name_vik_fact_cent	Cent	true
factions_screen_name_vik_fact_dene	Dene	true
factions_screen_name_vik_fact_separatists_east_engle	East Engle Usurpers	true
factions_attack_desc_vik_fact_brega	You are attacking Brega	true
factions_clan_summary_name_vik_fact_mierce	placeholder	true
factions_senator_text_gain_1_att_fact_red	%n of %n Nobles	true
factions_screen_name_vik_fact_fortriu	Fortriu	true
factions_attack_desc_vik_fact_fortriu	You are attacking Fortriu	true
factions_screen_adjective_vik_fact_separatists_gwined	Gwined Usurpers	true
factions_defend_desc_vik_fact_osraige	You are defending against Osraige	true
factions_senator_text_gain_1_vik_fact_heimiliborg	%n of %n Nobles	true
factions_senator_text_lose_n_vik_fact_wicing	%n of %n Nobles	true
factions_defend_desc_vik_fact_gwent	You are defending against Gwent	true
factions_senator_text_n_out_of_n_vik_fact_steinnborg	%n of %n Nobles	true
factions_defend_desc_vik_fact_bandits	You are defending against Bandits	true
factions_senator_text_lose_1_vik_fact_wicing	%n of %n Nobles	true
factions_attack_desc_vik_fact_circenn	You are attacking Circenn	true
factions_screen_name_vik_fact_circenn	Circenn	true
factions_screen_name_when_rebels_vik_fact_west_seaxe	West Seaxe Rebels	true
factions_clan_summary_name_when_shogun_vik_fact_northleode	placeholder	true
factions_attack_desc_vik_fact_dyfet	You are attacking Dewet	true
factions_senator_text_gain_n_vik_fact_cumbra	%n of %n Nobles	true
factions_screen_name_when_shogun_vik_fact_vedrafjordr	placeholder	true
factions_screen_name_when_shogun_vik_fact_veisafjordr	placeholder	true
factions_screen_adjective_vik_fact_strat_clut	Strat Clut	true
factions_screen_name_when_rebels_vik_fact_separatists_circenn	Circenn Usurpers	true
factions_screen_name_when_rebels_vik_fact_hellirborg_usurpers	Hellirborg Rebels	true
factions_senator_text_gain_1_vik_fact_cumbra	%n of %n Nobles	true
factions_senator_text_lose_1_vik_fact_hellirborg_usurpers	%n of %n Nobles	true
factions_clan_summary_name_vik_fact_haeden	placeholder	true
factions_clan_summary_name_vik_fact_dyflin	placeholder	true
factions_clan_summary_name_when_shogun_att_fact_blue	placeholder	true
factions_senator_text_lose_1_vik_fact_separatists_circenn	%n of %n Nobles	true
factions_screen_adjective_vik_fact_hellirborg	Hellirborg	true
factions_screen_adjective_vik_fact_normaunds	Normaund	true
factions_defend_desc_vik_fact_westmoringas	You are defending against Westmoringas	true
factions_attack_desc_vik_fact_mide	You are attacking Mide	true
factions_screen_name_when_rebels_vik_fact_east_engle	East Engle Rebels	true
factions_clan_summary_name_when_shogun_vik_fact_separatists_sudreyar	placeholder	true
factions_clan_summary_name_vik_fact_defena	placeholder	true
factions_screen_name_vik_fact_norse	Norse	true
factions_clan_summary_name_vik_fact_caisil	placeholder	true
factions_senator_text_n_out_of_n_vik_fact_separatists_viking	%n of %n Nobles	true
factions_screen_adjective_vik_fact_northymbre	Northanhymbra	true
factions_clan_summary_name_vik_fact_athfochla	placeholder	true
factions_screen_name_when_shogun_vik_fact_northleode_usurpers	placeholder	true
factions_clan_summary_name_when_shogun_vik_fact_gallgoidel	placeholder	true
factions_clan_summary_name_att_fact_yellow	placeholder	true
factions_screen_name_vik_fact_separatists_scottish	Scottish Usurpers	true
factions_clan_summary_name_vik_fact_hwicce	placeholder	true
factions_clan_summary_name_vik_fact_airgialla	placeholder	true
factions_screen_name_vik_fact_separatists_west_seaxe	West Seaxe Usurpers	true
factions_screen_adjective_vik_fact_airgialla	Airgialla	true
factions_screen_name_when_rebels_vik_fact_suth_seaxe	Suth Seaxe Rebels	true
factions_clan_summary_name_when_shogun_vik_fact_airer_goidel	placeholder	true
factions_defend_desc_vik_fact_ulaid	You are defending against Ulaid	true
factions_defend_desc_vik_fact_powis	You are defending against Powis	true
factions_screen_adjective_vik_fact_athfochla	Athfochla	true
factions_screen_adjective_vik_fact_breifne	Breifne	true
factions_clan_summary_name_vik_fact_normaunds	placeholder	true
factions_screen_name_when_shogun_vik_fact_east_seaxe	placeholder	true
factions_clan_summary_name_vik_fact_separatists_northymbre	placeholder	true
factions_senator_text_gain_n_vik_fact_rebels_irish	%n of %n Nobles	true
factions_senator_text_gain_1_vik_fact_rebels_irish	%n of %n Nobles	true
factions_senator_text_gain_n_vik_fact_rebels_welsh	%n of %n Nobles	true
factions_senator_text_gain_1_vik_fact_rebels_welsh	%n of %n Nobles	true
factions_clan_summary_name_vik_fact_cerneu	placeholder	true
factions_clan_summary_name_vik_fact_djurby	placeholder	true
factions_defend_desc_vik_fact_brega	You are defending against Brega	true
factions_screen_name_when_shogun_vik_fact_separatists_english	placeholder	true
factions_defend_desc_vik_fact_breifne	You are defending against Breifne	true
factions_attack_desc_vik_fact_gwent	You are attacking Gwent	true
factions_senator_text_lose_n_vik_fact_cumbra	%n of %n Nobles	true
factions_senator_text_lose_1_vik_fact_cumbra	%n of %n Nobles	true
factions_defend_desc_vik_fact_dene	You are defending against Dene	true
factions_attack_desc_vik_fact_separatists_west_seaxe	You are attacking West Seaxe Usurpers	true
factions_defend_desc_vik_fact_cent	You are defending against Cent	true
factions_screen_name_vik_fact_mide	Mide	true
factions_senator_text_gain_n_vik_fact_wicing	%n of %n Nobles	true
factions_defend_desc_vik_fact_dyfet	You are defending against Dewet	true
factions_clan_summary_name_when_shogun_vik_fact_separatists_viking	placeholder	true
factions_screen_name_vik_fact_rebels_viking	Viking Rebels	true
factions_screen_adjective_vik_fact_seisilwig_usurpers	Seisilwig	true
factions_screen_name_vik_fact_iarmuma	Iarmuma	true
factions_attack_desc_vik_fact_iarmuma	You are attacking Iarmuma	true
factions_senator_text_gain_1_vik_fact_wicing	%n of %n Nobles	true
factions_attack_desc_vik_fact_separatists_scottish	You are attacking Scottish Usurpers	true
factions_clan_summary_name_vik_fact_laigin	placeholder	true
factions_senator_text_n_out_of_n_vik_fact_gallgoidel	%n of %n Nobles	true
factions_attack_desc_vik_fact_separatists_east_engle	You are attacking East Engle Usurpers	true
factions_senator_text_n_out_of_n_vik_fact_northleode	%n of %n Nobles	true
factions_clan_summary_name_vik_fact_gwined	placeholder	true
factions_screen_name_vik_fact_rebels_scottish	Scottish Rebels	true
factions_attack_desc_vik_fact_rebels_scottish	You are attacking Scottish Rebels	true
factions_screen_name_vik_fact_caisil_usurpers	Caisil Usurpers	true
factions_attack_desc_vik_fact_caisil_usurpers	You are attacking Caisil Usurpers	true
factions_screen_name_vik_fact_aileach	Ailech	true
factions_clan_summary_name_vik_fact_finngaill	placeholder	true
factions_attack_desc_vik_fact_aileach	You are attacking Ailech	true
factions_screen_adjective_vik_fact_separatists_mierce	Mierce Usurpers	true
factions_senator_text_gain_1_vik_fact_hellirborg_usurpers	%n of %n Nobles	true
factions_clan_summary_name_vik_fact_jorvik	placeholder	true
factions_senator_text_gain_1_vik_fact_separatists_circenn	%n of %n Nobles	true
factions_clan_summary_name_vik_fact_rebels_english	placeholder	true
factions_attack_desc_vik_fact_dene	You are attacking Dene	true
factions_clan_summary_name_vik_fact_separatists_strat_clut	placeholder	true
factions_screen_name_vik_fact_westmoringas	Westmoringas	true
factions_attack_desc_vik_fact_cent	You are attacking Cent	true
factions_attack_desc_vik_fact_powis	You are attacking Powis	true
factions_screen_adjective_vik_fact_bandits	Bandit	true
factions_senator_text_lose_1_att_fact_red	%n of %n Nobles	true
factions_attack_desc_vik_fact_ulaid	You are attacking Ulaid	true
factions_screen_name_when_rebels_vik_fact_heimiliborg	Heimiliborg Rebels	true
factions_screen_name_vik_fact_desmuma	Desmuma	true
factions_attack_desc_vik_fact_desmuma	You are attacking Desmuma	true
factions_screen_adjective_vik_fact_finngaill	Finngaill	true
factions_screen_adjective_vik_fact_osraige	Osraige	true
factions_defend_desc_vik_fact_separatists_scottish	You are defending against Scottish Usurpers	true
factions_senator_text_lose_1_vik_fact_heimiliborg	%n of %n Nobles	true
factions_clan_summary_name_when_shogun_vik_fact_steinnborg	placeholder	true
factions_screen_name_when_rebels_att_fact_red	Red	true
factions_screen_adjective_vik_fact_brechinauc	Brechinauc	true
factions_screen_adjective_vik_fact_separatists_dyflin	Dyflin Usurpers	true
factions_defend_desc_vik_fact_cerneu	You are defending against Cerneu	true
factions_defend_desc_vik_fact_djurby	You are defending against Djurby	true
factions_screen_name_when_rebels_vik_fact_northleode	Northanhymbran Rebels	true
factions_defend_desc_vik_fact_separatists_northymbre	You are defending against Jórvík Usurpers	true
factions_clan_summary_name_vik_fact_breifne	placeholder	true
factions_screen_name_when_shogun_vik_fact_myrrborg	placeholder	true
factions_clan_summary_name_when_shogun_vik_fact_west_seaxe	placeholder	true
factions_screen_name_when_rebels_vik_fact_athfochla	Athfochla Rebels	true
factions_screen_name_when_shogun_vik_fact_seisilwig_usurpers	placeholder	true
factions_senator_text_gain_n_vik_fact_bandits	%n of %n Nobles	true
factions_screen_adjective_vik_fact_tuadmuma	Tuadmuma	true
factions_attack_desc_vik_fact_wicing	You are attacking Wicing	true
factions_senator_text_gain_n_vik_fact_norse	%n of %n Nobles	true
factions_senator_text_gain_1_vik_fact_norse	%n of %n Nobles	true
factions_senator_text_n_out_of_n_vik_fact_hylrborg	%n of %n Nobles	true
factions_senator_text_gain_n_vik_fact_separatists_west_seaxe	%n of %n Nobles	true
factions_screen_name_when_rebels_vik_fact_airgialla	Airgialla Rebels	true
factions_screen_name_when_rebels_vik_fact_tuadmuma	Tuadmuma Rebels	true
factions_screen_name_when_shogun_vik_fact_normaunds	placeholder	true
factions_senator_text_gain_n_vik_fact_osraige	%n of %n Nobles	true
factions_senator_text_gain_1_vik_fact_separatists_west_seaxe	%n of %n Nobles	true
factions_senator_text_lose_n_vik_fact_dene	%n of %n Nobles	true
factions_senator_text_lose_1_vik_fact_dene	%n of %n Nobles	true
factions_screen_name_when_shogun_vik_fact_athfochla	placeholder	true
factions_senator_text_lose_n_vik_fact_cent	%n of %n Nobles	true
factions_senator_text_lose_1_vik_fact_cent	%n of %n Nobles	true
factions_clan_summary_name_when_shogun_vik_fact_norse	placeholder	true
factions_screen_adjective_vik_fact_east_seaxe	East Seaxe	true
factions_screen_adjective_vik_fact_dubgaill	Dubgaill	true
factions_defend_desc_vik_fact_laigin	You are defending against Laigin	true
factions_screen_name_when_rebels_vik_fact_normaunds	Normaund Rebels	true
factions_screen_name_when_shogun_vik_fact_airgialla	placeholder	true
factions_senator_text_gain_n_att_fact_blue	%n of %n Nobles	true
factions_senator_text_gain_1_att_fact_blue	%n of %n Nobles	true
factions_screen_name_when_rebels_vik_fact_dubgaill	Dubgaill Rebels	true
factions_senator_text_n_out_of_n_vik_fact_nordmann	%n of %n Nobles	true
factions_senator_text_n_out_of_n_vik_fact_separatists_circenn	%n of %n Nobles	true
factions_senator_text_n_out_of_n_vik_fact_hellirborg_usurpers	%n of %n Nobles	true
factions_senator_text_lose_n_vik_fact_rebels_viking	%n of %n Nobles	true
factions_senator_text_lose_1_vik_fact_rebels_viking	%n of %n Nobles	true
factions_clan_summary_name_vik_fact_nordmann	placeholder	true
factions_senator_text_n_out_of_n_vik_fact_airgialla	%n of %n Nobles	true
factions_defend_desc_vik_fact_gwined	You are defending against Gwined	true
factions_clan_summary_name_when_shogun_vik_fact_heimiliborg	placeholder	true
factions_senator_text_gain_n_vik_fact_separatists_sudreyar	%n of %n Nobles	true
factions_senator_text_gain_1_vik_fact_separatists_sudreyar	%n of %n Nobles	true
factions_clan_summary_name_when_shogun_vik_fact_suth_seaxe	placeholder	true
factions_defend_desc_vik_fact_rebels_english	You are defending against English Rebels	true
factions_senator_text_n_out_of_n_vik_fact_athfochla	%n of %n Nobles	true
factions_screen_name_when_shogun_vik_fact_separatists_dyflin	placeholder	true
factions_screen_name_when_shogun_vik_fact_brechinauc	placeholder	true
factions_defend_desc_vik_fact_jorvik	You are defending against Bandits	true
factions_clan_summary_name_when_shogun_att_fact_red	placeholder	true
factions_screen_name_vik_fact_cumbra	Cumbra	true
factions_screen_name_when_shogun_vik_fact_sudreyar	placeholder	true
factions_screen_name_when_shogun_vik_fact_separatists_mierce	placeholder	true
factions_clan_summary_name_vik_fact_hylrborg	placeholder	true
factions_senator_text_n_out_of_n_vik_fact_normaunds	%n of %n Nobles	true
factions_screen_name_when_shogun_vik_fact_dorsaete	placeholder	true
factions_clan_summary_name_when_shogun_vik_fact_east_engle	placeholder	true
factions_screen_name_when_shogun_vik_fact_connacht	placeholder	true
factions_senator_text_gain_n_vik_fact_airer_goidel	%n of %n Nobles	true
factions_senator_text_gain_1_vik_fact_airer_goidel	%n of %n Nobles	true
factions_defend_desc_vik_fact_separatists_strat_clut	You are defending against Strat Clut Usurpers	true
factions_senator_text_lose_n_vik_fact_separatists_scottish	%n of %n Nobles	true
factions_senator_text_lose_1_vik_fact_separatists_scottish	%n of %n Nobles	true
factions_screen_adjective_vik_fact_orkneyar	Orkneyar	true
factions_screen_name_when_rebels_vik_fact_gallgoidel	Gallgoidel Rebels	true
factions_screen_name_when_rebels_vik_fact_orkneyar	Orkneyar Rebels	true
factions_senator_text_gain_n_vik_fact_separatists_east_engle	%n of %n Nobles	true
factions_senator_text_lose_n_vik_fact_breifne	%n of %n Nobles	true
factions_senator_text_gain_1_vik_fact_separatists_east_engle	%n of %n Nobles	true
factions_screen_name_when_rebels_vik_fact_separatists_viking	Viking Usurpers	true
factions_screen_adjective_vik_fact_sudreyar	Sudreyar	true
factions_defend_desc_vik_fact_mierce	You are defending against Mierce	true
factions_clan_summary_name_when_shogun_vik_fact_separatists_circenn	placeholder	true
factions_senator_text_lose_n_vik_fact_mide	%n of %n Nobles	true
factions_senator_text_lose_1_vik_fact_mide	%n of %n Nobles	true
factions_senator_text_n_out_of_n_vik_fact_east_engle	%n of %n Nobles	true
factions_clan_summary_name_when_shogun_vik_fact_rebels_irish	placeholder	true
factions_clan_summary_name_when_shogun_vik_fact_hellirborg_usurpers	placeholder	true
factions_screen_name_when_shogun_vik_fact_strat_clut	placeholder	true
factions_screen_name_when_rebels_vik_fact_sudreyar	Sudreyar Rebels	true
factions_clan_summary_name_when_shogun_vik_fact_rebels_welsh	placeholder	true
factions_screen_name_when_rebels_vik_fact_finngaill	Finngaill Rebels	true
factions_clan_summary_name_vik_fact_osraige	placeholder	true
factions_attack_desc_vik_fact_cumbra	You are attacking Cumbra	true
factions_screen_name_when_shogun_vik_fact_hellirborg	placeholder	true
factions_senator_text_n_out_of_n_vik_fact_bedeborg	%n of %n Nobles	true
factions_senator_text_n_out_of_n_vik_fact_ledeborg	%n of %n Nobles	true
factions_clan_summary_name_vik_fact_bandits	placeholder	true
factions_senator_text_gain_n_vik_fact_breifne	%n of %n Nobles	true
factions_screen_name_when_shogun_vik_fact_separatists_gwined	placeholder	true
factions_clan_summary_name_vik_fact_hlymrekr	placeholder	true
factions_senator_text_lose_n_vik_fact_norse	%n of %n Nobles	true
factions_senator_text_lose_1_vik_fact_norse	%n of %n Nobles	true
factions_senator_text_lose_n_vik_fact_separatists_west_seaxe	%n of %n Nobles	true
factions_screen_name_when_shogun_vik_fact_orkneyar	placeholder	true
factions_senator_text_n_out_of_n_vik_fact_suth_seaxe	%n of %n Nobles	true
factions_screen_name_when_shogun_vik_fact_finngaill	placeholder	true
factions_senator_text_lose_1_vik_fact_separatists_west_seaxe	%n of %n Nobles	true
factions_defend_desc_vik_fact_dyflin	You are defending against Dyflin	true
factions_screen_adjective_vik_fact_dorsaete	Dorsaete	true
factions_defend_desc_vik_fact_haeden	You are defending against Haeden	true
factions_screen_adjective_vik_fact_connacht	Connacht	true
factions_screen_name_when_rebels_vik_fact_dorsaete	Dorsaete Rebels	true
factions_screen_name_when_rebels_vik_fact_connacht	Connacht Rebels	true
factions_clan_summary_name_vik_fact_separatists_mide	placeholder	true
factions_senator_text_n_out_of_n_vik_fact_separatists_mide	%n of %n Nobles	true
factions_defend_desc_vik_fact_caisil	You are defending against Caisil	true
factions_defend_desc_vik_fact_defena	You are defending against Defena	true
factions_senator_text_lose_n_vik_fact_westmoringas	%n of %n Nobles	true
factions_senator_text_lose_1_vik_fact_westmoringas	%n of %n Nobles	true
factions_senator_text_lose_n_vik_fact_separatists_east_engle	%n of %n Nobles	true
factions_screen_name_when_shogun_vik_fact_tuadmuma	placeholder	true
factions_senator_text_lose_1_vik_fact_separatists_east_engle	%n of %n Nobles	true
factions_clan_summary_name_when_shogun_vik_fact_rebels_viking	placeholder	true
factions_screen_name_when_rebels_vik_fact_steinnborg	Steinnborg Rebels	true
factions_screen_name_vik_fact_wicing	Wicing	true
factions_senator_text_n_out_of_n_vik_fact_finngaill	%n of %n Nobles	true
factions_defend_desc_vik_fact_hwicce	You are defending against Hwicce	true
factions_screen_adjective_vik_fact_myrrborg	Myrrborg	true
factions_defend_desc_att_fact_yellow	Red	true
factions_screen_name_when_rebels_vik_fact_myrrborg	Myrrborg Rebels	true
factions_senator_text_n_out_of_n_vik_fact_hlymrekr	%n of %n Nobles	true
factions_clan_summary_name_vik_fact_bedeborg	placeholder	true
factions_clan_summary_name_vik_fact_ledeborg	placeholder	true
factions_screen_name_when_shogun_vik_fact_northymbre	placeholder	true
factions_screen_name_when_shogun_vik_fact_dubgaill	placeholder	true
factions_senator_text_n_out_of_n_vik_fact_west_seaxe	%n of %n Nobles	true
factions_senator_text_n_out_of_n_att_fact_red	%n of %n Nobles	true
factions_senator_text_lose_n_vik_fact_bandits	%n of %n Nobles	true
factions_senator_text_gain_n_vik_fact_rebels_viking	%n of %n Nobles	true
factions_senator_text_gain_1_vik_fact_rebels_viking	%n of %n Nobles	true
factions_senator_text_n_out_of_n_vik_fact_heimiliborg	%n of %n Nobles	true
factions_senator_text_lose_n_vik_fact_osraige	%n of %n Nobles	true
factions_senator_text_lose_n_vik_fact_ulaid	%n of %n Nobles	true
factions_senator_text_lose_1_vik_fact_ulaid	%n of %n Nobles	true
factions_screen_name_vik_fact_rebels_welsh	Welsh Rebels	true
factions_screen_name_when_shogun_vik_fact_hlymrekr_usurpers	placeholder	true
factions_screen_name_when_shogun_vik_fact_separatists_viking	placeholder	true
factions_senator_text_lose_n_vik_fact_powis	%n of %n Nobles	true
factions_senator_text_lose_1_vik_fact_powis	%n of %n Nobles	true
factions_screen_name_vik_fact_rebels_irish	Irish Rebels	true
factions_screen_name_when_rebels_vik_fact_strat_clut	Strat Clut Rebels	true
factions_screen_name_when_rebels_vik_fact_seisilwig	Seisilwig Rebels	true
factions_clan_summary_name_vik_fact_iarmuma	placeholder	true
factions_screen_adjective_vik_fact_west_seaxe	West Seaxe	true
factions_screen_name_vik_fact_laigin	Laigin	true
factions_screen_name_when_rebels_vik_fact_hellirborg	Hellirborg Rebels	true
factions_senator_text_n_out_of_n_vik_fact_gliwissig	%n of %n Nobles	true
factions_screen_adjective_vik_fact_nordmann	Nordmann	true
factions_screen_name_when_rebels_vik_fact_nordmann	Nordmann Rebels	true
factions_senator_text_n_out_of_n_vik_fact_dubgaill	%n of %n Nobles	true
factions_senator_text_lose_n_vik_fact_aileach	%n of %n Nobles	true
factions_senator_text_lose_n_vik_fact_caisil_usurpers	%n of %n Nobles	true
factions_senator_text_lose_n_vik_fact_rebels_scottish	%n of %n Nobles	true
factions_attack_desc_vik_fact_caisil	You are attacking Caisil	true
factions_clan_summary_name_when_shogun_vik_fact_separatists_english	placeholder	true
factions_attack_desc_vik_fact_defena	You are attacking Defena	true
factions_screen_name_vik_fact_separatists_northymbre	Jórvík Usurpers	true
factions_clan_summary_name_vik_fact_orkneyar	placeholder	true
factions_screen_name_vik_fact_djurby	Djurby	true
factions_screen_name_when_rebels_vik_fact_hlymrekr_usurpers	Hlymrekr	true
factions_screen_name_when_rebels_vik_fact_separatists_gwined	Gwined Usurpers	true
factions_screen_name_vik_fact_cerneu	Cerneu	true
factions_screen_name_when_shogun_vik_fact_hlymrekr	placeholder	true
factions_senator_text_gain_n_vik_fact_mide	%n of %n Nobles	true
factions_senator_text_gain_1_vik_fact_mide	%n of %n Nobles	true
factions_clan_summary_name_when_shogun_vik_fact_east_seaxe	placeholder	true
factions_screen_name_when_shogun_vik_fact_seisilwig	placeholder	true
factions_senator_text_gain_n_vik_fact_circenn	%n of %n Nobles	true
factions_senator_text_n_out_of_n_vik_fact_grantebru	%n of %n Nobles	true
factions_screen_name_when_shogun_vik_fact_separatists_mide	placeholder	true
factions_attack_desc_att_fact_yellow	Red	true
factions_screen_adjective_vik_fact_hylrborg	Hylrborg	true
factions_attack_desc_vik_fact_hwicce	You are attacking Hwicce	true
factions_screen_name_when_rebels_vik_fact_hylrborg	Hylrborg Rebels	true
factions_senator_text_n_out_of_n_vik_fact_tuadmuma	%n of %n Nobles	true
factions_senator_text_lose_n_vik_fact_desmuma	%n of %n Nobles	true
factions_senator_text_gain_n_vik_fact_fortriu	%n of %n Nobles	true
factions_senator_text_n_out_of_n_vik_fact_veisafjordr	%n of %n Nobles	true
factions_senator_text_n_out_of_n_vik_fact_vedrafjordr	%n of %n Nobles	true
factions_clan_summary_name_vik_fact_tuadmuma	placeholder	true
factions_screen_name_vik_fact_separatists_strat_clut	Strat Clut Usurpers	true
factions_screen_name_when_shogun_vik_fact_grantebru	placeholder	true
factions_clan_summary_name_vik_fact_desmuma	placeholder	true
factions_screen_name_when_rebels_vik_fact_gliwissig	Gliwissig Rebels	true
factions_screen_adjective_vik_fact_suth_seaxe	Suth Seaxe	true
factions_clan_summary_name_when_shogun_vik_fact_dyfet	placeholder	true
factions_attack_desc_vik_fact_haeden	You are attacking Haeden	true
factions_screen_name_when_shogun_vik_fact_steinnborg	placeholder	true
factions_senator_text_gain_n_vik_fact_brega	%n of %n Nobles	true
factions_senator_text_gain_1_vik_fact_brega	%n of %n Nobles	true
factions_attack_desc_vik_fact_dyflin	You are attacking Dyflin	true
factions_senator_text_n_out_of_n_vik_fact_seisilwig	%n of %n Nobles	true
factions_senator_text_n_out_of_n_vik_fact_orkneyar	%n of %n Nobles	true
factions_senator_text_n_out_of_n_vik_fact_northleode_usurpers	%n of %n Nobles	true
factions_clan_summary_name_vik_fact_rebels_scottish	placeholder	true
factions_attack_desc_vik_fact_mierce	You are attacking Mierce	true
factions_clan_summary_name_vik_fact_dubgaill	placeholder	true
factions_screen_name_when_rebels_vik_fact_northymbre	Jórvík Rebels	true
factions_clan_summary_name_vik_fact_caisil_usurpers	placeholder	true
factions_screen_name_vik_fact_gwined	Gwined	true
factions_senator_text_gain_n_vik_fact_westmoringas	%n of %n Nobles	true
factions_clan_summary_name_vik_fact_aileach	placeholder	true
factions_senator_text_gain_1_vik_fact_westmoringas	%n of %n Nobles	true
factions_screen_name_when_shogun_vik_fact_gliwissig	placeholder	true
factions_screen_name_when_shogun_vik_fact_bedeborg	placeholder	true
factions_screen_name_when_shogun_vik_fact_ledeborg	placeholder	true
factions_screen_name_when_rebels_vik_fact_grantebru	Grantebru Rebels	true
factions_clan_summary_name_when_shogun_vik_fact_brega	placeholder	true
factions_screen_adjective_vik_fact_east_engle	East Engle	true
factions_senator_text_lose_n_vik_fact_gwent	%n of %n Nobles	true
factions_senator_text_lose_1_vik_fact_gwent	%n of %n Nobles	true
factions_defend_desc_vik_fact_cumbra	You are defending against Cumbra	true
factions_screen_name_vik_fact_jorvik	Bandits	true
factions_senator_text_gain_n_vik_fact_dyfet	%n of %n Nobles	true
factions_senator_text_gain_1_vik_fact_dyfet	%n of %n Nobles	true
factions_screen_name_vik_fact_rebels_english	English Rebels	true
factions_senator_text_n_out_of_n_vik_fact_hlymrekr_usurpers	%n of %n Nobles	true
factions_senator_text_lose_n_vik_fact_iarmuma	%n of %n Nobles	true
factions_clan_summary_name_when_shogun_vik_fact_vedrafjordr	placeholder	true
factions_screen_name_when_shogun_vik_fact_northleode	placeholder	true
factions_senator_text_n_out_of_n_vik_fact_holdrness	%n of %n Nobles	true
factions_clan_summary_name_when_shogun_vik_fact_veisafjordr	placeholder	true
factions_clan_summary_name_vik_fact_myrrborg	placeholder	true
factions_attack_desc_vik_fact_separatists_strat_clut	You are attacking Strat Clut Usurpers	true
factions_screen_name_when_rebels_vik_fact_seisilwig_usurpers	Seisilwig Rebels	true
factions_senator_text_gain_n_vik_fact_dene	%n of %n Nobles	true
factions_senator_text_gain_1_vik_fact_dene	%n of %n Nobles	true
factions_senator_text_gain_n_vik_fact_cent	%n of %n Nobles	true
factions_senator_text_gain_1_vik_fact_cent	%n of %n Nobles	true
factions_clan_summary_name_when_shogun_vik_fact_powis	placeholder	true
factions_clan_summary_name_when_shogun_vik_fact_ulaid	placeholder	true
factions_screen_name_vik_fact_haeden	Haeden	true
factions_senator_text_n_out_of_n_vik_fact_veidrborg	%n of %n Nobles	true
factions_screen_adjective_vik_fact_separatists_irish	Irish Usurpers	true
factions_screen_adjective_vik_fact_separatists_welsh	Welsh Usurpers	true
factions_screen_name_vik_fact_dyflin	Dyflin	true
factions_senator_text_n_out_of_n_vik_fact_dorsaete	%n of %n Nobles	true
factions_senator_text_n_out_of_n_vik_fact_connacht	%n of %n Nobles	true
factions_senator_text_lose_n_att_fact_blue	%n of %n Nobles	true
factions_senator_text_lose_1_att_fact_blue	%n of %n Nobles	true
factions_senator_text_gain_n_vik_fact_iarmuma	%n of %n Nobles	true
factions_senator_text_n_out_of_n_vik_fact_separatists_english	%n of %n Nobles	true
factions_screen_name_vik_fact_mierce	Mierce	true
factions_defend_desc_vik_fact_rebels_irish	You are defending against Irish Rebels	true
factions_senator_text_n_out_of_n_vik_fact_westernas	%n of %n Nobles	true
factions_defend_desc_vik_fact_rebels_welsh	You are defending against Welsh Rebels	true
factions_attack_desc_vik_fact_gwined	You are attacking Gwined	true
factions_clan_summary_name_vik_fact_fortriu	placeholder	true
factions_clan_summary_name_vik_fact_separatists_east_engle	placeholder	true
factions_senator_text_n_out_of_n_vik_fact_sudreyar	%n of %n Nobles	true
factions_clan_summary_name_vik_fact_separatists_welsh	placeholder	true
factions_clan_summary_name_vik_fact_separatists_irish	placeholder	true
factions_screen_adjective_vik_fact_bedeborg	Bedeborg	true
factions_screen_adjective_vik_fact_ledeborg	Ledeborg	true
factions_senator_text_gain_n_vik_fact_ulaid	%n of %n Nobles	true
factions_attack_desc_vik_fact_jorvik	You are attacking Bandits	true
factions_senator_text_gain_1_vik_fact_ulaid	%n of %n Nobles	true
factions_attack_desc_vik_fact_rebels_english	You are attacking English Rebels	true
factions_senator_text_gain_n_vik_fact_powis	%n of %n Nobles	true
factions_senator_text_gain_1_vik_fact_powis	%n of %n Nobles	true
factions_screen_name_when_rebels_vik_fact_bedeborg	Bedeborg Rebels	true
factions_screen_name_when_rebels_vik_fact_ledeborg	Ledeborg Rebels	true
factions_clan_summary_name_vik_fact_circenn	placeholder	true
factions_senator_text_lose_n_vik_fact_dyfet	%n of %n Nobles	true
factions_senator_text_lose_1_vik_fact_dyfet	%n of %n Nobles	true
factions_senator_text_gain_n_vik_fact_gwent	%n of %n Nobles	true
factions_senator_text_gain_1_vik_fact_gwent	%n of %n Nobles	true
factions_senator_text_lose_n_vik_fact_airer_goidel	%n of %n Nobles	true
factions_clan_summary_name_vik_fact_separatists_west_seaxe	placeholder	true
factions_senator_text_lose_1_vik_fact_airer_goidel	%n of %n Nobles	true
factions_screen_name_when_rebels_vik_fact_veidrborg	Veidrborg Rebels	true
factions_screen_name_when_shogun_vik_fact_nordmann	placeholder	true
factions_senator_text_n_out_of_n_vik_fact_east_seaxe	%n of %n Nobles	true
factions_senator_text_lose_n_vik_fact_circenn	%n of %n Nobles	true
factions_senator_text_gain_n_vik_fact_separatists_scottish	%n of %n Nobles	true
factions_attack_desc_vik_fact_laigin	You are attacking Laigin	true
factions_senator_text_gain_1_vik_fact_separatists_scottish	%n of %n Nobles	true
factions_screen_name_when_rebels_vik_fact_brechinauc	Brechinauc Rebels	true
factions_clan_summary_name_vik_fact_sudreyar	placeholder	true
factions_screen_name_when_rebels_vik_fact_separatists_dyflin	Dyflin Usurpers	true
factions_screen_name_when_shogun_vik_fact_westernas	placeholder	true
factions_screen_name_when_rebels_vik_fact_holdrness	Holdrness Rebels	true
factions_senator_text_lose_n_vik_fact_fortriu	%n of %n Nobles	true
factions_senator_text_gain_n_vik_fact_desmuma	%n of %n Nobles	true
factions_screen_name_when_rebels_vik_fact_separatists_mide	Mide Usurpers	true
factions_screen_name_when_rebels_vik_fact_separatists_mierce	Mierce Usurpers	true
factions_screen_name_vik_fact_caisil	Caisil	true
factions_screen_name_vik_fact_defena	Defena	true
factions_attack_desc_vik_fact_rebels_irish	You are attacking Irish Rebels	true
factions_attack_desc_vik_fact_separatists_northymbre	You are attacking Jórvík Usurpers	true
factions_clan_summary_name_vik_fact_dorsaete	placeholder	true
factions_senator_text_lose_n_vik_fact_brega	%n of %n Nobles	true
factions_senator_text_lose_1_vik_fact_brega	%n of %n Nobles	true
factions_attack_desc_vik_fact_rebels_welsh	You are attacking Welsh Rebels	true
factions_senator_text_lose_n_vik_fact_separatists_sudreyar	%n of %n Nobles	true
factions_senator_text_lose_1_vik_fact_separatists_sudreyar	%n of %n Nobles	true
factions_clan_summary_name_vik_fact_connacht	placeholder	true
factions_attack_desc_vik_fact_djurby	You are attacking Djurby	true
factions_attack_desc_vik_fact_cerneu	You are attacking Cerneu	true
factions_screen_name_when_shogun_vik_fact_veidrborg	placeholder	true
factions_screen_name_when_shogun_vik_fact_hylrborg	placeholder	true
factions_screen_adjective_vik_fact_separatists_mide	Mide Usurpers	true
factions_clan_summary_name_when_shogun_vik_fact_northleode_usurpers	placeholder	true
factions_screen_name_att_fact_yellow	Red	true
factions_screen_name_when_shogun_vik_fact_gallgoidel	placeholder	true
factions_defend_desc_vik_fact_wicing	You are defending against Wicing	true
factions_screen_adjective_vik_fact_hlymrekr	Hlymrekr	true
factions_screen_name_vik_fact_hwicce	Hwicce	true
factions_senator_text_n_out_of_n_vik_fact_myrrborg	%n of %n Nobles	true
factions_screen_name_when_shogun_vik_fact_holdrness	placeholder	true
factions_screen_name_when_rebels_vik_fact_hlymrekr	Hlymrekr Rebels	true
factions_screen_name_when_rebels_vik_fact_westernas	Westernas Rebels	true
factions_senator_text_gain_n_vik_fact_aileach	%n of %n Nobles	true
factions_senator_text_gain_n_vik_fact_rebels_scottish	%n of %n Nobles	true
factions_senator_text_gain_n_vik_fact_caisil_usurpers	%n of %n Nobles	true
factions_clan_summary_name_when_shogun_vik_fact_gwent	placeholder	true
factions_senator_text_n_out_of_n_vik_fact_osraige	%n of %n Nobles	true
factions_senator_text_lose_n_vik_fact_heimiliborg	%n of %n Nobles	true
factions_senator_text_lose_n_vik_fact_tuadmuma	%n of %n Nobles	true
factions_senator_text_lose_1_vik_fact_tuadmuma	%n of %n Nobles	true
factions_senator_text_gain_n_vik_fact_bedeborg	%n of %n Nobles	true
factions_senator_text_gain_n_vik_fact_ledeborg	%n of %n Nobles	true
factions_senator_text_gain_1_vik_fact_bedeborg	%n of %n Nobles	true
factions_senator_text_gain_1_vik_fact_ledeborg	%n of %n Nobles	true
factions_screen_name_when_shogun_vik_fact_westmoringas	placeholder	true
factions_screen_name_when_rebels_vik_fact_gwined	Gwined Rebels	true
factions_screen_name_vik_fact_northymbre	Jórvík	true
factions_senator_text_gain_1_vik_fact_east_seaxe	%n of %n Nobles	true
factions_senator_text_lose_n_att_fact_red	%n of %n Nobles	true
factions_senator_text_n_out_of_n_vik_fact_bandits	%n of %n Nobles	true
factions_screen_name_when_shogun_vik_fact_powis	placeholder	true
factions_screen_name_when_shogun_vik_fact_ulaid	placeholder	true
factions_senator_text_lose_n_vik_fact_hlymrekr_usurpers	%n of %n Nobles	true
factions_senator_text_lose_1_vik_fact_hlymrekr_usurpers	%n of %n Nobles	true
factions_senator_text_gain_n_vik_fact_east_seaxe	%n of %n Nobles	true
factions_screen_name_when_rebels_vik_fact_rebels_english	English Rebels	true
factions_senator_text_n_out_of_n_vik_fact_gwent	%n of %n Nobles	true
factions_screen_name_when_rebels_vik_fact_jorvik	Bandits Rebels	true
factions_screen_adjective_vik_fact_separatists_west_seaxe	West Seaxe Usurpers	true
factions_senator_text_gain_n_vik_fact_hellirborg_usurpers	%n of %n Nobles	true
factions_senator_text_gain_n_vik_fact_separatists_circenn	%n of %n Nobles	true
factions_senator_text_lose_n_vik_fact_dubgaill	%n of %n Nobles	true
factions_senator_text_lose_1_vik_fact_dubgaill	%n of %n Nobles	true
factions_screen_name_when_rebels_vik_fact_separatists_strat_clut	Strat Clut Usurpers	true
factions_attack_desc_vik_fact_seisilwig_usurpers	You are attacking Seisilwig Usurpers	true
factions_screen_name_vik_fact_separatists_welsh	Welsh Usurpers	true
factions_screen_name_when_rebels_vik_fact_cent	Cent Rebels	true
factions_screen_name_when_rebels_vik_fact_ulaid	Ulaid Rebels	true
factions_screen_name_when_rebels_vik_fact_dene	Dene Rebels	true
factions_screen_name_when_rebels_vik_fact_powis	Powis Rebels	true
factions_screen_name_vik_fact_separatists_irish	Irish Usurpers	true
factions_screen_adjective_vik_fact_dene	Dene	true
factions_screen_name_when_shogun_vik_fact_wicing	placeholder	true
factions_senator_text_lose_n_vik_fact_seisilwig	%n of %n Nobles	true
factions_senator_text_lose_1_vik_fact_seisilwig	%n of %n Nobles	true
factions_screen_adjective_vik_fact_cent	Cent	true
factions_clan_summary_name_when_shogun_vik_fact_breifne	placeholder	true
factions_defend_desc_vik_fact_gallgoidel	You are defending against the Gallgoidel	true
factions_screen_adjective_vik_fact_separatists_east_engle	East Engle Usurpers	true
factions_clan_summary_name_when_shogun_vik_fact_westernas	placeholder	true
factions_screen_name_when_rebels_vik_fact_gwent	Gwent Rebels	true
factions_screen_name_when_shogun_vik_fact_mide	placeholder	true
factions_senator_text_gain_n_vik_fact_hlymrekr	%n of %n Nobles	true
factions_senator_text_gain_1_vik_fact_hlymrekr	%n of %n Nobles	true
factions_screen_name_when_rebels_vik_fact_cerneu	Cerneu Rebels	true
factions_screen_name_vik_fact_separatists_gwined	Gwined Usurpers	true
factions_screen_name_when_rebels_vik_fact_djurby	Djurby Rebels	true
factions_attack_desc_vik_fact_separatists_mierce	You are attacking Mierce Usurpers	true
factions_senator_text_gain_n_vik_fact_veidrborg	%n of %n Nobles	true
factions_senator_text_gain_1_vik_fact_veidrborg	%n of %n Nobles	true
factions_defend_desc_vik_fact_northleode	You are defending against Northanhymbra	true
factions_screen_name_when_rebels_vik_fact_separatists_northymbre	Jórvík Usurpers	true
factions_senator_text_gain_n_vik_fact_holdrness	%n of %n Nobles	true
factions_senator_text_gain_1_vik_fact_holdrness	%n of %n Nobles	true
factions_senator_text_lose_n_vik_fact_grantebru	%n of %n Nobles	true
factions_senator_text_lose_1_vik_fact_grantebru	%n of %n Nobles	true
factions_senator_text_gain_n_vik_fact_separatists_mide	%n of %n Nobles	true
factions_senator_text_gain_1_vik_fact_separatists_mide	%n of %n Nobles	true
factions_clan_summary_name_when_shogun_vik_fact_holdrness	placeholder	true
factions_clan_summary_name_att_fact_red	placeholder	true
factions_screen_adjective_vik_fact_separatists_scottish	Scottish Usurpers	true
factions_screen_name_when_shogun_vik_fact_gwent	placeholder	true
factions_screen_name_vik_fact_strat_clut	Strat Clut	true
factions_senator_text_lose_n_vik_fact_orkneyar	%n of %n Nobles	true
factions_senator_text_lose_1_vik_fact_orkneyar	%n of %n Nobles	true
factions_senator_text_n_out_of_n_vik_fact_powis	%n of %n Nobles	true
factions_senator_text_n_out_of_n_vik_fact_ulaid	%n of %n Nobles	true
factions_screen_name_when_rebels_vik_fact_separatists_scottish	Scottish Usurpers	true
factions_clan_summary_name_when_shogun_vik_fact_veidrborg	placeholder	true
factions_clan_summary_name_vik_fact_heimiliborg	placeholder	true
factions_attack_desc_vik_fact_separatists_dyflin	You are attacking Dyflin Usurpers	true
factions_screen_name_when_rebels_vik_fact_laigin	Laigin Rebels	true
factions_attack_desc_vik_fact_brechinauc	You are attacking Brechinauc	true
factions_senator_text_lose_n_vik_fact_gliwissig	%n of %n Nobles	true
factions_senator_text_lose_1_vik_fact_gliwissig	%n of %n Nobles	true
factions_senator_text_gain_n_vik_fact_westernas	%n of %n Nobles	true
factions_senator_text_gain_1_vik_fact_westernas	%n of %n Nobles	true
factions_screen_name_vik_fact_hellirborg	Hellirborg	true
factions_senator_text_n_out_of_n_vik_fact_breifne	%n of %n Nobles	true
factions_clan_summary_name_vik_fact_east_engle	placeholder	true
factions_senator_text_gain_n_vik_fact_hylrborg	%n of %n Nobles	true
factions_senator_text_gain_1_vik_fact_hylrborg	%n of %n Nobles	true
factions_clan_summary_name_vik_fact_airer_goidel	placeholder	true
factions_senator_text_n_out_of_n_vik_fact_brega	%n of %n Nobles	true
factions_senator_text_gain_n_vik_fact_seisilwig	%n of %n Nobles	true
factions_senator_text_gain_1_vik_fact_seisilwig	%n of %n Nobles	true
factions_attack_desc_vik_fact_separatists_gwined	You are attacking Gwined Usurpers	true
factions_screen_name_when_rebels_vik_fact_caisil	Caisil Rebels	true
factions_screen_name_vik_fact_separatists_mierce	Mierce Usurpers	true
factions_screen_name_when_rebels_vik_fact_defena	Defena Rebels	true
factions_clan_summary_name_when_shogun_vik_fact_hlymrekr_usurpers	placeholder	true
factions_senator_text_lose_n_vik_fact_sudreyar	%n of %n Nobles	true
factions_senator_text_lose_1_vik_fact_sudreyar	%n of %n Nobles	true
factions_screen_name_when_rebels_vik_fact_mide	Mide Rebels	true
factions_screen_adjective_vik_fact_mide	Mide	true
factions_defend_desc_vik_fact_steinnborg	You are defending against Steinnborg	true
factions_screen_name_when_rebels_vik_fact_hwicce	Hwicce Rebels	true
factions_screen_name_when_rebels_att_fact_yellow	Red	true
factions_senator_text_lose_1_vik_fact_east_seaxe	%n of %n Nobles	true
factions_senator_text_gain_n_vik_fact_nordmann	%n of %n Nobles	true
factions_senator_text_gain_1_vik_fact_nordmann	%n of %n Nobles	true
factions_senator_text_n_out_of_n_att_fact_blue	%n of %n Nobles	true
factions_clan_summary_name_vik_fact_suth_seaxe	placeholder	true
factions_attack_desc_vik_fact_strat_clut	You are attacking Strat Clut	true
factions_clan_summary_name_vik_fact_separatists_sudreyar	placeholder	true
factions_senator_text_lose_n_vik_fact_east_seaxe	%n of %n Nobles	true
factions_senator_text_lose_n_vik_fact_dorsaete	%n of %n Nobles	true
factions_senator_text_lose_1_vik_fact_dorsaete	%n of %n Nobles	true
factions_senator_text_lose_n_vik_fact_connacht	%n of %n Nobles	true
factions_senator_text_lose_1_vik_fact_connacht	%n of %n Nobles	true
factions_senator_text_gain_n_vik_fact_hlymrekr_usurpers	%n of %n Nobles	true
factions_senator_text_gain_1_vik_fact_hlymrekr_usurpers	%n of %n Nobles	true
factions_clan_summary_name_when_shogun_vik_fact_bandits	placeholder	true
factions_senator_text_n_out_of_n_vik_fact_dyfet	%n of %n Nobles	true
factions_clan_summary_name_when_shogun_vik_fact_seisilwig	placeholder	true
factions_clan_summary_name_vik_fact_separatists_circenn	placeholder	true
factions_clan_summary_name_when_shogun_vik_fact_osraige	placeholder	true
factions_screen_name_vik_fact_separatists_dyflin	Dyflin Usurpers	true
factions_clan_summary_name_vik_fact_hellirborg_usurpers	placeholder	true
factions_screen_name_vik_fact_brechinauc	Brechinauc	true
factions_screen_name_when_shogun_vik_fact_cumbra	placeholder	true
factions_screen_name_when_shogun_vik_fact_separatists_scottish	placeholder	true
factions_attack_desc_vik_fact_hellirborg	You are attacking Hellirborg	true
factions_senator_text_lose_n_vik_fact_hellirborg_usurpers	%n of %n Nobles	true
factions_senator_text_lose_n_vik_fact_separatists_circenn	%n of %n Nobles	true
factions_senator_text_lose_n_vik_fact_myrrborg	%n of %n Nobles	true
factions_senator_text_lose_1_vik_fact_myrrborg	%n of %n Nobles	true
factions_defend_desc_vik_fact_separatists_viking	You are defending against Viking Usurpers	true
factions_screen_name_when_rebels_vik_fact_mierce	Mierce Rebels	true
factions_senator_text_lose_n_vik_fact_westernas	%n of %n Nobles	true
factions_senator_text_lose_1_vik_fact_westernas	%n of %n Nobles	true
factions_senator_text_gain_n_vik_fact_gliwissig	%n of %n Nobles	true
factions_senator_text_gain_1_vik_fact_gliwissig	%n of %n Nobles	true
factions_attack_desc_vik_fact_northymbre	You are attacking Jórvík	true
factions_clan_summary_name_when_shogun_vik_fact_grantebru	placeholder	true
factions_screen_name_when_shogun_vik_fact_dyfet	placeholder	true
factions_screen_name_when_rebels_vik_fact_brega	Brega Rebels	true
factions_screen_name_when_rebels_vik_fact_westmoringas	Westmoringas Rebels	true
factions_senator_text_n_out_of_n_vik_fact_separatists_sudreyar	%n of %n Nobles	true
factions_screen_adjective_vik_fact_westmoringas	Westmoringas	true
factions_clan_summary_name_att_fact_blue	placeholder	true
factions_senator_text_gain_n_vik_fact_heimiliborg	%n of %n Nobles	true
factions_screen_name_when_shogun_vik_fact_cent	placeholder	true
factions_screen_name_when_shogun_vik_fact_dene	placeholder	true
factions_clan_summary_name_vik_fact_west_seaxe	placeholder	true
factions_screen_name_vik_fact_seisilwig_usurpers	Seisilwig Usurpers	true
factions_senator_text_lose_n_vik_fact_holdrness	%n of %n Nobles	true
factions_senator_text_lose_1_vik_fact_holdrness	%n of %n Nobles	true
factions_senator_text_gain_n_vik_fact_grantebru	%n of %n Nobles	true
factions_senator_text_gain_1_vik_fact_grantebru	%n of %n Nobles	true
factions_clan_summary_name_when_shogun_vik_fact_gliwissig	placeholder	true
factions_senator_text_gain_n_att_fact_red	%n of %n Nobles	true
factions_screen_name_when_shogun_vik_fact_brega	placeholder	true
factions_screen_name_when_rebels_vik_fact_dyfet	Dewet Rebels	true
factions_senator_text_n_out_of_n_vik_fact_airer_goidel	%n of %n Nobles	true
factions_screen_name_when_rebels_vik_fact_dyflin	Dyflin Rebels	true
factions_screen_name_when_rebels_vik_fact_haeden	Haeden Rebels	true
factions_senator_text_lose_n_vik_fact_veidrborg	%n of %n Nobles	true
factions_senator_text_lose_1_vik_fact_veidrborg	%n of %n Nobles	true
factions_senator_text_lose_n_vik_fact_nordmann	%n of %n Nobles	true
factions_senator_text_lose_1_vik_fact_nordmann	%n of %n Nobles	true
factions_senator_text_gain_n_vik_fact_connacht	%n of %n Nobles	true
factions_senator_text_gain_1_vik_fact_connacht	%n of %n Nobles	true
factions_screen_name_when_shogun_vik_fact_airer_goidel	placeholder	true
factions_senator_text_gain_n_vik_fact_dorsaete	%n of %n Nobles	true
factions_senator_text_gain_1_vik_fact_dorsaete	%n of %n Nobles	true
factions_screen_name_when_shogun_vik_fact_caisil	placeholder	true
factions_screen_name_when_shogun_vik_fact_defena	placeholder	true
factions_senator_text_lose_n_vik_fact_normaunds	%n of %n Nobles	true
factions_senator_text_lose_1_vik_fact_normaunds	%n of %n Nobles	true
factions_senator_text_gain_n_vik_fact_finngaill	%n of %n Nobles	true
factions_senator_text_gain_1_vik_fact_finngaill	%n of %n Nobles	true
factions_senator_text_n_out_of_n_vik_fact_cent	%n of %n Nobles	true
factions_senator_text_n_out_of_n_vik_fact_dene	%n of %n Nobles	true
factions_clan_summary_name_vik_fact_separatists_english	placeholder	true
factions_screen_name_when_shogun_att_fact_yellow	placeholder	true
factions_screen_name_vik_fact_gallgoidel	Gallgoidel	true
factions_screen_name_when_shogun_vik_fact_hwicce	placeholder	true
factions_senator_text_n_out_of_n_vik_fact_fortriu	%n of %n Nobles	true
factions_senator_text_gain_n_vik_fact_vedrafjordr	%n of %n Nobles	true
factions_senator_text_gain_n_vik_fact_veisafjordr	%n of %n Nobles	true
factions_clan_summary_name_when_shogun_vik_fact_separatists_west_seaxe	placeholder	true
factions_senator_text_lose_n_vik_fact_hylrborg	%n of %n Nobles	true
factions_senator_text_lose_1_vik_fact_hylrborg	%n of %n Nobles	true
factions_screen_name_when_shogun_vik_fact_separatists_sudreyar	placeholder	true
factions_defend_desc_vik_fact_northymbre	You are defending against Jórvík	true
factions_attack_desc_vik_fact_separatists_viking	You are attacking Viking Usurpers	true
factions_senator_text_n_out_of_n_vik_fact_rebels_viking	%n of %n Nobles	true
factions_senator_text_lose_n_vik_fact_airgialla	%n of %n Nobles	true
factions_senator_text_lose_1_vik_fact_airgialla	%n of %n Nobles	true
factions_senator_text_gain_1_vik_fact_west_seaxe	%n of %n Nobles	true
factions_clan_summary_name_when_shogun_vik_fact_finngaill	placeholder	true
factions_senator_text_n_out_of_n_vik_fact_circenn	%n of %n Nobles	true
factions_senator_text_gain_n_vik_fact_sudreyar	%n of %n Nobles	true
factions_senator_text_gain_1_vik_fact_sudreyar	%n of %n Nobles	true
factions_attack_desc_vik_fact_separatists_welsh	You are attacking Welsh Usurpers	true
factions_clan_summary_name_vik_fact_separatists_scottish	placeholder	true
factions_attack_desc_vik_fact_separatists_irish	You are attacking Irish Usurpers	true
factions_senator_text_gain_n_vik_fact_west_seaxe	%n of %n Nobles	true
factions_screen_name_when_rebels_vik_fact_cumbra	Cumbra Rebels	true
factions_clan_summary_name_when_shogun_vik_fact_iarmuma	placeholder	true
factions_senator_text_lose_n_vik_fact_athfochla	%n of %n Nobles	true
factions_senator_text_lose_1_vik_fact_athfochla	%n of %n Nobles	true
factions_senator_text_gain_n_vik_fact_northleode_usurpers	%n of %n Nobles	true
factions_defend_desc_vik_fact_strat_clut	You are defending against Strat Clut	true
factions_clan_summary_name_when_shogun_vik_fact_separatists_east_engle	placeholder	true
factions_screen_name_when_shogun_vik_fact_mierce	placeholder	true
factions_senator_text_n_out_of_n_vik_fact_separatists_scottish	%n of %n Nobles	true
factions_senator_text_gain_1_vik_fact_east_engle	%n of %n Nobles	true
factions_screen_name_when_shogun_att_fact_blue	placeholder	true
factions_clan_summary_name_when_shogun_vik_fact_caisil_usurpers	placeholder	true
factions_senator_text_gain_n_vik_fact_east_engle	%n of %n Nobles	true
factions_screen_name_when_shogun_vik_fact_rebels_viking	placeholder	true
factions_clan_summary_name_when_shogun_vik_fact_rebels_scottish	placeholder	true
factions_defend_desc_vik_fact_hellirborg	You are defending against Hellirborg	true
factions_clan_summary_name_when_shogun_vik_fact_aileach	placeholder	true
factions_senator_text_lose_n_vik_fact_separatists_english	%n of %n Nobles	true
factions_senator_text_gain_n_vik_fact_myrrborg	%n of %n Nobles	true
factions_senator_text_gain_1_vik_fact_myrrborg	%n of %n Nobles	true
factions_clan_summary_name_vik_fact_dene	placeholder	true
factions_screen_name_vik_fact_northleode	Northanhymbra	true
factions_clan_summary_name_vik_fact_cent	placeholder	true
factions_defend_desc_vik_fact_separatists_gwined	You are defending against Gwined Usurpers	true
factions_senator_text_gain_1_vik_fact_suth_seaxe	%n of %n Nobles	true
factions_screen_name_when_rebels_vik_fact_rebels_viking	Viking Rebels	true
factions_senator_text_gain_n_vik_fact_suth_seaxe	%n of %n Nobles	true
factions_screen_name_when_shogun_vik_fact_haeden	placeholder	true
factions_clan_summary_name_when_shogun_vik_fact_desmuma	placeholder	true
factions_attack_desc_vik_fact_steinnborg	You are attacking Steinnborg	true
factions_screen_name_when_shogun_vik_fact_dyflin	placeholder	true
factions_senator_text_lose_1_vik_fact_west_seaxe	%n of %n Nobles	true
factions_clan_summary_name_when_shogun_vik_fact_normaunds	placeholder	true
factions_senator_text_n_out_of_n_vik_fact_iarmuma	%n of %n Nobles	true
factions_senator_text_gain_n_vik_fact_separatists_english	%n of %n Nobles	true
factions_screen_name_when_rebels_att_fact_blue	Red	true
factions_senator_text_gain_n_vik_fact_dubgaill	%n of %n Nobles	true
factions_senator_text_gain_1_vik_fact_dubgaill	%n of %n Nobles	true
factions_senator_text_lose_n_vik_fact_west_seaxe	%n of %n Nobles	true
factions_clan_summary_name_when_shogun_vik_fact_circenn	placeholder	true
factions_clan_summary_name_vik_fact_westmoringas	placeholder	true
factions_senator_text_gain_n_vik_fact_athfochla	%n of %n Nobles	true
factions_senator_text_gain_1_vik_fact_athfochla	%n of %n Nobles	true
factions_screen_adjective_att_fact_blue	Red	true
factions_screen_name_when_shogun_vik_fact_gwined	placeholder	true
factions_screen_name_when_rebels_vik_fact_norse	Norse Rebels	true
factions_defend_desc_vik_fact_brechinauc	You are defending against Brechinauc	true
factions_screen_name_when_shogun_vik_fact_jorvik	placeholder	true
factions_senator_text_gain_n_vik_fact_airgialla	%n of %n Nobles	true
factions_senator_text_gain_1_vik_fact_airgialla	%n of %n Nobles	true
factions_screen_name_when_shogun_vik_fact_rebels_english	placeholder	true
factions_clan_summary_name_when_shogun_vik_fact_fortriu	placeholder	true
factions_defend_desc_vik_fact_separatists_dyflin	You are defending against Dyflin Usurpers	true
factions_clan_summary_name_when_shogun_vik_fact_airgialla	placeholder	true
factions_senator_text_lose_n_vik_fact_northleode_usurpers	%n of %n Nobles	true
factions_screen_name_when_shogun_vik_fact_separatists_strat_clut	placeholder	true
factions_senator_text_lose_n_vik_fact_bedeborg	%n of %n Nobles	true
factions_senator_text_lose_n_vik_fact_ledeborg	%n of %n Nobles	true
factions_senator_text_lose_1_vik_fact_bedeborg	%n of %n Nobles	true
factions_senator_text_lose_1_vik_fact_ledeborg	%n of %n Nobles	true
factions_senator_text_gain_n_vik_fact_tuadmuma	%n of %n Nobles	true
factions_senator_text_gain_1_vik_fact_tuadmuma	%n of %n Nobles	true
factions_senator_text_n_out_of_n_vik_fact_separatists_east_engle	%n of %n Nobles	true
factions_defend_desc_vik_fact_separatists_mierce	You are defending against Mierce Usurpers	true
factions_attack_desc_vik_fact_northleode	You are attacking Northanhymbra	true
factions_clan_summary_name_when_shogun_vik_fact_athfochla	placeholder	true
factions_screen_name_when_shogun_vik_fact_norse	placeholder	true
factions_defend_desc_vik_fact_separatists_irish	You are defending against Irish Usurpers	true
factions_clan_summary_name_vik_fact_veisafjordr	placeholder	true
factions_senator_text_n_out_of_n_vik_fact_mide	%n of %n Nobles	true
factions_defend_desc_vik_fact_separatists_welsh	You are defending against Welsh Usurpers	true
factions_clan_summary_name_vik_fact_vedrafjordr	placeholder	true
factions_senator_text_gain_n_vik_fact_normaunds	%n of %n Nobles	true
factions_senator_text_gain_1_vik_fact_normaunds	%n of %n Nobles	true
factions_screen_name_when_rebels_vik_fact_wicing	Wicing Rebels	true
factions_screen_name_vik_fact_steinnborg	Steinnborg	true
factions_senator_text_lose_n_vik_fact_finngaill	%n of %n Nobles	true
factions_senator_text_lose_1_vik_fact_finngaill	%n of %n Nobles	true
factions_senator_text_lose_1_vik_fact_suth_seaxe	%n of %n Nobles	true
factions_senator_text_lose_n_vik_fact_veisafjordr	%n of %n Nobles	true
factions_senator_text_lose_n_vik_fact_vedrafjordr	%n of %n Nobles	true
factions_senator_text_n_out_of_n_vik_fact_desmuma	%n of %n Nobles	true
factions_senator_text_lose_n_vik_fact_suth_seaxe	%n of %n Nobles	true
factions_defend_desc_vik_fact_seisilwig_usurpers	You are defending against Seisilwig Usurpers	true
factions_senator_text_n_out_of_n_vik_fact_separatists_west_seaxe	%n of %n Nobles	true
factions_clan_summary_name_vik_fact_east_seaxe	placeholder	true
factions_senator_text_gain_n_vik_fact_orkneyar	%n of %n Nobles	true
factions_senator_text_gain_1_vik_fact_orkneyar	%n of %n Nobles	true
factions_clan_summary_name_vik_fact_mide	placeholder	true
factions_senator_text_n_out_of_n_vik_fact_norse	%n of %n Nobles	true
factions_screen_name_when_shogun_vik_fact_separatists_northymbre	placeholder	true
factions_screen_name_when_shogun_vik_fact_cerneu	placeholder	true
factions_screen_name_when_shogun_vik_fact_djurby	placeholder	true
factions_screen_name_when_rebels_vik_fact_airer_goidel	Airer Goidel Rebels	true
factions_screen_adjective_vik_fact_airer_goidel	Airer Goidel	true
factions_clan_summary_name_vik_fact_northleode_usurpers	placeholder	true
factions_attack_desc_vik_fact_gallgoidel	You are attacking the Gallgoidel	true
factions_senator_text_n_out_of_n_vik_fact_rebels_scottish	%n of %n Nobles	true
factions_senator_text_n_out_of_n_vik_fact_caisil_usurpers	%n of %n Nobles	true
factions_senator_text_lose_1_vik_fact_east_engle	%n of %n Nobles	true
factions_senator_text_n_out_of_n_vik_fact_aileach	%n of %n Nobles	true
factions_senator_text_lose_n_vik_fact_east_engle	%n of %n Nobles	true
factions_senator_text_lose_n_vik_fact_hlymrekr	%n of %n Nobles	true
factions_senator_text_lose_1_vik_fact_hlymrekr	%n of %n Nobles	true
factions_screen_name_vik_fact_separatists_viking	Viking Usurpers	true
factions_screen_adjective_vik_fact_separatists_sudreyar	Sudreyar Usurpers	true
factions_senator_text_n_out_of_n_vik_fact_westmoringas	%n of %n Nobles	true
factions_screen_name_when_shogun_vik_fact_laigin	placeholder	true
factions_screen_name_when_rebels_vik_fact_separatists_sudreyar	Sudreyar Usurpers	true
factions_senator_text_lose_n_vik_fact_separatists_mide	%n of %n Nobles	true
factions_senator_text_lose_1_vik_fact_separatists_mide	%n of %n Nobles	true
factions_screen_name_when_shogun_vik_fact_bandits	placeholder	true
factions_screen_adjective_vik_fact_separatists_strat_clut	Strat Clut Usurpers	true
factions_attack_desc_vik_fact_holdrness	You are attacking Holdrness	true
factions_senator_text_gain_1_vik_fact_aileach	%n of %n Nobles	true
factions_clan_summary_name_when_shogun_vik_fact_connacht	placeholder	true
factions_clan_summary_name_when_shogun_vik_fact_dorsaete	placeholder	true
factions_screen_adjective_vik_fact_rebels_viking	Viking Rebels	true
factions_screen_name_vik_fact_hylrborg	Hylrborg	true
factions_screen_name_vik_fact_suth_seaxe	Suth Seaxe	true
factions_senator_text_gain_1_vik_fact_rebels_scottish	%n of %n Nobles	true
factions_senator_text_gain_1_vik_fact_caisil_usurpers	%n of %n Nobles	true
factions_screen_name_when_rebels_vik_fact_separatists_west_seaxe	West Seaxe Usurpers	true
factions_attack_desc_vik_fact_separatists_circenn	You are attacking Circenn Usurpers	true
factions_screen_name_vik_fact_separatists_circenn	Circenn Usurpers	true
factions_senator_text_gain_1_vik_fact_northleode	%n of %n Nobles	true
factions_screen_name_when_shogun_vik_fact_osraige	placeholder	true
factions_screen_name_vik_fact_hellirborg_usurpers	Hellirborg Usurpers	true
factions_attack_desc_vik_fact_hellirborg_usurpers	You are attacking Hellirborg	true
factions_attack_desc_vik_fact_veidrborg	You are attacking Veidrborg	true
factions_clan_summary_name_vik_fact_separatists_dyflin	placeholder	true
factions_senator_text_gain_n_vik_fact_northleode	%n of %n Nobles	true
factions_clan_summary_name_when_shogun_vik_fact_cumbra	placeholder	true
factions_defend_desc_vik_fact_gliwissig	You are defending against Gliwissig	true
factions_clan_summary_name_vik_fact_brechinauc	placeholder	true
factions_screen_adjective_vik_fact_gwined	Gwined	true
factions_senator_text_lose_1_vik_fact_separatists_viking	%n of %n Nobles	true
factions_screen_name_when_rebels_vik_fact_circenn	Circenn Rebels	true
factions_attack_desc_vik_fact_westernas	You are attacking Westernas	true
factions_senator_text_lose_1_vik_fact_fortriu	%n of %n Nobles	true
factions_clan_summary_name_vik_fact_separatists_mierce	placeholder	true
factions_senator_text_gain_1_vik_fact_desmuma	%n of %n Nobles	true
factions_senator_text_lose_n_vik_fact_separatists_viking	%n of %n Nobles	true
factions_defend_desc_vik_fact_bedeborg	You are defending against Bedeborg	true
factions_defend_desc_vik_fact_ledeborg	You are defending against Ledeborg	true
factions_screen_name_vik_fact_east_engle	East Engle	true
factions_attack_desc_vik_fact_hlymrekr	You are attacking Hlymrekr	true
factions_screen_name_vik_fact_nordmann	Nordmann	true
factions_screen_adjective_vik_fact_rebels_english	English Rebels	true
factions_defend_desc_vik_fact_vedrafjordr	You are defending against Vedrafjordr	true
factions_clan_summary_name_vik_fact_rebels_viking	placeholder	true
factions_screen_adjective_vik_fact_jorvik	Bandits	true
factions_defend_desc_vik_fact_veisafjordr	You are defending against Veisafjordr	true
factions_screen_name_when_rebels_vik_fact_fortriu	Fortriu Rebels	true
factions_screen_name_when_rebels_vik_fact_rebels_welsh	Welsh Rebels	true
factions_senator_text_lose_1_vik_fact_circenn	%n of %n Nobles	true
factions_clan_summary_name_when_shogun_vik_fact_sudreyar	placeholder	true
factions_screen_name_when_rebels_vik_fact_rebels_irish	Irish Rebels	true
factions_defend_desc_vik_fact_grantebru	You are defending against Grantebru	true
factions_attack_desc_vik_fact_separatists_mide	You are attacking Mide Usurpers	true
factions_screen_adjective_vik_fact_rebels_irish	Irish Rebels	true
factions_screen_adjective_vik_fact_rebels_welsh	Welsh Rebels	true
factions_defend_desc_vik_fact_east_seaxe	You are defending against East Seaxe	true
factions_clan_summary_name_vik_fact_seisilwig_usurpers	placeholder	true
factions_screen_name_vik_fact_west_seaxe	West Seaxe	true
factions_screen_adjective_vik_fact_laigin	Laigin	true
factions_defend_desc_vik_fact_northleode_usurpers	You are defending against Northanhymbra Usurpers	true
factions_screen_name_vik_fact_finngaill	Finngaill	true
factions_defend_desc_vik_fact_seisilwig	You are defending against Seisilwig	true
factions_screen_adjective_vik_fact_djurby	Djurby	true
factions_screen_adjective_vik_fact_cerneu	Cerneu	true
factions_screen_adjective_vik_fact_separatists_northymbre	Jórvík Usurpers	true
factions_senator_text_gain_1_vik_fact_gallgoidel	%n of %n Nobles	true
factions_screen_adjective_vik_fact_separatists_english	English Usurpers	true
factions_senator_text_gain_n_vik_fact_gallgoidel	%n of %n Nobles	true
factions_clan_summary_name_when_shogun_vik_fact_myrrborg	placeholder	true
factions_senator_text_gain_1_vik_fact_iarmuma	%n of %n Nobles	true
factions_screen_name_when_rebels_vik_fact_separatists_east_engle	East Engle Usurpers	true
factions_attack_desc_vik_fact_bedeborg	You are attacking Bedeborg	true
factions_attack_desc_vik_fact_ledeborg	You are attacking Ledeborg	true
factions_defend_desc_vik_fact_hlymrekr	You are defending against Hlymrekr	true
factions_senator_text_lose_1_vik_fact_steinnborg	%n of %n Nobles	true
factions_senator_text_n_out_of_n_vik_fact_wicing	%n of %n Nobles	true
factions_defend_desc_vik_fact_separatists_mide	You are defending against Mide Usurpers	true
factions_senator_text_lose_n_vik_fact_steinnborg	%n of %n Nobles	true
factions_defend_desc_vik_fact_hlymrekr_usurpers	You are defending against Hlymrekr Usurpers	true
factions_clan_summary_name_when_shogun_vik_fact_dubgaill	placeholder	true
factions_senator_text_lose_1_vik_fact_iarmuma	%n of %n Nobles	true
factions_defend_desc_vik_fact_holdrness	You are defending against Holdrness	true
factions_defend_desc_vik_fact_nordmann	You are defending against Nordmann	true
factions_attack_desc_vik_fact_west_seaxe	You are attacking West Seaxe	true
factions_screen_name_vik_fact_bedeborg	Bedeborg	true
factions_screen_name_vik_fact_ledeborg	Ledeborg	true
factions_senator_text_gain_1_vik_fact_separatists_viking	%n of %n Nobles	true
factions_defend_desc_vik_fact_separatists_english	You are defending against English Usurpers	true
factions_screen_name_when_rebels_vik_fact_iarmuma	Iarmuma Rebels	true
factions_screen_name_when_shogun_vik_fact_breifne	placeholder	true
factions_clan_summary_name_when_shogun_vik_fact_wicing	placeholder	true
factions_attack_desc_vik_fact_gliwissig	You are attacking Gliwissig	true
factions_senator_text_gain_n_vik_fact_separatists_viking	%n of %n Nobles	true
factions_defend_desc_vik_fact_veidrborg	You are defending against Veidrborg	true
factions_screen_adjective_vik_fact_defena	Defena	true
factions_senator_text_lose_1_vik_fact_northleode	%n of %n Nobles	true
factions_screen_adjective_vik_fact_caisil	Caisil	true
factions_senator_text_lose_n_vik_fact_northleode	%n of %n Nobles	true
factions_clan_summary_name_when_shogun_vik_fact_tuadmuma	placeholder	true
factions_clan_summary_name_vik_fact_northymbre	placeholder	true
factions_defend_desc_vik_fact_westernas	You are defending against Westernas	true
factions_defend_desc_vik_fact_hylrborg	You are defending against Hylrborg	true
factions_screen_adjective_vik_fact_northleode_usurpers	Northanhymbra	true
factions_screen_adjective_vik_fact_hwicce	Hwicce	true
factions_screen_adjective_att_fact_yellow	Red	true
factions_attack_desc_vik_fact_grantebru	You are attacking Grantebru	true
factions_screen_name_att_fact_red	Red	true
factions_attack_desc_att_fact_red	Red	true
factions_senator_text_gain_1_vik_fact_steinnborg	%n of %n Nobles	true
factions_screen_adjective_vik_fact_veisafjordr	Veisafjordr	true
factions_screen_name_vik_fact_airgialla	Airgialla	true
factions_senator_text_lose_1_vik_fact_desmuma	%n of %n Nobles	true
factions_screen_adjective_vik_fact_vedrafjordr	Vedrafjordr	true
factions_senator_text_gain_1_vik_fact_fortriu	%n of %n Nobles	true
factions_senator_text_gain_n_vik_fact_steinnborg	%n of %n Nobles	true
factions_clan_summary_name_when_shogun_vik_fact_orkneyar	placeholder	true
factions_screen_name_vik_fact_hlymrekr	Hlymrekr	true
factions_attack_desc_vik_fact_nordmann	You are attacking Nordmann	true
factions_attack_desc_vik_fact_suth_seaxe	You are attacking Suth Seaxe	true
factions_clan_summary_name_vik_fact_strat_clut	placeholder	true
factions_screen_name_vik_fact_heimiliborg	Heimiliborg	true
factions_screen_adjective_vik_fact_dyflin	Dyflin	true
factions_clan_summary_name_vik_fact_norse	placeholder	true
factions_attack_desc_vik_fact_heimiliborg	You are attacking Heimiliborg	true
factions_screen_adjective_vik_fact_haeden	Haeden	true
factions_senator_text_lose_1_vik_fact_gallgoidel	%n of %n Nobles	true
factions_screen_name_when_rebels_vik_fact_desmuma	Desmuma Rebels	true
factions_senator_text_lose_n_vik_fact_gallgoidel	%n of %n Nobles	true
factions_screen_name_vik_fact_athfochla	Athfochla	true
factions_screen_name_vik_fact_separatists_mide	Mide Usurpers	true
factions_senator_text_gain_1_vik_fact_circenn	%n of %n Nobles	true
factions_clan_summary_name_vik_fact_hellirborg	placeholder	true
factions_attack_desc_vik_fact_seisilwig	You are attacking Seisilwig	true
factions_screen_adjective_vik_fact_mierce	Mierce	true
factions_clan_summary_name_vik_fact_separatists_gwined	placeholder	true
factions_screen_name_when_shogun_vik_fact_rebels_welsh	placeholder	true
factions_screen_name_vik_fact_normaunds	Normaunds	true
factions_senator_text_lose_1_vik_fact_aileach	%n of %n Nobles	true
factions_screen_name_when_shogun_vik_fact_rebels_irish	placeholder	true
factions_senator_text_lose_1_vik_fact_caisil_usurpers	%n of %n Nobles	true
factions_attack_desc_vik_fact_east_engle	You are attacking East Engle	true
factions_screen_adjective_vik_fact_norse	Norse	true
factions_senator_text_lose_1_vik_fact_rebels_scottish	%n of %n Nobles	true
factions_attack_desc_vik_fact_hylrborg	You are attacking Hylrborg	true
factions_screen_name_when_rebels_vik_fact_caisil_usurpers	Caisil Rebels	true
factions_screen_name_when_rebels_vik_fact_rebels_scottish	Scottish Rebels	true
factions_screen_name_when_rebels_vik_fact_aileach	Ailech Rebels	true
factions_senator_text_n_out_of_n_vik_fact_cumbra	%n of %n Nobles	true
factions_attack_desc_vik_fact_hlymrekr_usurpers	You are attacking Hlymrekr	true
factions_senator_text_gain_1_vik_fact_hellirborg	%n of %n Nobles	true
factions_clan_summary_name_vik_fact_gwent	placeholder	true
factions_screen_name_when_rebels_vik_fact_bandits	Bandits	true
factions_senator_text_n_out_of_n_vik_fact_mierce	%n of %n Nobles	true
factions_senator_text_lose_1_vik_fact_osraige	%n of %n Nobles	true
factions_screen_name_vik_fact_holdrness	Holdrness	true
factions_clan_summary_name_when_shogun_vik_fact_bedeborg	placeholder	true
factions_clan_summary_name_when_shogun_vik_fact_ledeborg	placeholder	true
factions_screen_adjective_vik_fact_heimiliborg	Heimiliborg	true
factions_senator_text_gain_n_vik_fact_hellirborg	%n of %n Nobles	true
factions_clan_summary_name_when_shogun_vik_fact_separatists_strat_clut	placeholder	true
factions_screen_name_vik_fact_dubgaill	Dubgaill	true
factions_attack_desc_vik_fact_myrrborg	You are attacking Myrrborg	true
factions_defend_desc_vik_fact_east_engle	You are defending against East Engle	true
factions_screen_adjective_vik_fact_cumbra	Cumbra	true
factions_attack_desc_vik_fact_vedrafjordr	You are attacking Vedrafjordr	true
factions_screen_name_vik_fact_veisafjordr	Veisafjordr	true
factions_attack_desc_vik_fact_veisafjordr	You are attacking Veisafjordr	true
factions_screen_name_vik_fact_vedrafjordr	Vedrafjordr	true
factions_screen_name_when_rebels_vik_fact_osraige	Osraige Rebels	true
factions_senator_text_gain_1_vik_fact_strat_clut	%n of %n Nobles	true
factions_senator_text_lose_1_vik_fact_bandits	%n of %n Nobles	true
factions_senator_text_n_out_of_n_vik_fact_rebels_welsh	%n of %n Nobles	true
factions_screen_name_vik_fact_veidrborg	Veidrborg	true
factions_screen_adjective_att_fact_red	Red	true
factions_senator_text_n_out_of_n_vik_fact_rebels_irish	%n of %n Nobles	true
factions_clan_summary_name_vik_fact_steinnborg	placeholder	true
factions_defend_desc_vik_fact_sudreyar	You are defending against Sudreyar	true
factions_senator_text_gain_n_vik_fact_strat_clut	%n of %n Nobles	true
factions_screen_name_when_shogun_vik_fact_circenn	placeholder	true
factions_senator_text_lose_1_vik_fact_seisilwig_usurpers	%n of %n Nobles	true
factions_screen_name_vik_fact_westernas	Westernas	true
factions_clan_summary_name_when_shogun_vik_fact_gwined	placeholder	true
factions_defend_desc_vik_fact_dorsaete	You are defending against Dorsaete	true
factions_senator_text_lose_n_vik_fact_seisilwig_usurpers	%n of %n Nobles	true
factions_screen_name_vik_fact_tuadmuma	Tuadmuma	true
factions_defend_desc_vik_fact_connacht	You are defending against Connacht	true
factions_defend_desc_vik_fact_suth_seaxe	You are defending against Suth Seaxe	true
factions_defend_desc_vik_fact_separatists_circenn	You are defending against Circenn Usurpers	true
factions_senator_text_gain_1_vik_fact_separatists_gwined	%n of %n Nobles	true
factions_defend_desc_vik_fact_hellirborg_usurpers	You are defending against Hellirborg Usurpers	true
factions_screen_name_when_shogun_vik_fact_fortriu	placeholder	true
factions_senator_text_n_out_of_n_vik_fact_haeden	%n of %n Nobles	true
factions_clan_summary_name_when_shogun_vik_fact_jorvik	placeholder	true
factions_senator_text_gain_n_vik_fact_separatists_gwined	%n of %n Nobles	true
factions_senator_text_n_out_of_n_vik_fact_dyflin	%n of %n Nobles	true
factions_clan_summary_name_when_shogun_vik_fact_rebels_english	placeholder	true
factions_screen_adjective_vik_fact_gwent	Gwent	true
factions_senator_text_lose_1_vik_fact_separatists_mierce	%n of %n Nobles	true
factions_senator_text_n_out_of_n_vik_fact_caisil	%n of %n Nobles	true
factions_senator_text_n_out_of_n_vik_fact_defena	%n of %n Nobles	true
factions_clan_summary_name_when_shogun_vik_fact_hlymrekr	placeholder	true
factions_defend_desc_vik_fact_airgialla	You are defending against Airgialla	true
factions_clan_summary_name_vik_fact_separatists_viking	placeholder	true
factions_senator_text_lose_n_vik_fact_separatists_mierce	%n of %n Nobles	true
factions_screen_name_vik_fact_orkneyar	Orkneyar	true
factions_screen_adjective_vik_fact_ulaid	Ulaid	true
factions_defend_desc_vik_fact_myrrborg	You are defending against Myrrborg	true
factions_screen_adjective_vik_fact_powis	Powis	true
factions_clan_summary_name_when_shogun_vik_fact_separatists_welsh	placeholder	true
factions_clan_summary_name_when_shogun_vik_fact_separatists_irish	placeholder	true
factions_senator_text_n_out_of_n_att_fact_yellow	%n of %n Nobles	true
factions_clan_summary_name_when_shogun_vik_fact_laigin	placeholder	true
factions_attack_desc_vik_fact_finngaill	You are attacking Finngaill	true
factions_defend_desc_vik_fact_athfochla	You are defending against Athfochla	true
factions_senator_text_n_out_of_n_vik_fact_hwicce	%n of %n Nobles	true
factions_attack_desc_vik_fact_sudreyar	You are attacking Sudreyar	true
factions_clan_summary_name_when_shogun_vik_fact_separatists_mide	placeholder	true
factions_defend_desc_vik_fact_normaunds	You are defending against Normaunds	true
factions_clan_summary_name_when_shogun_vik_fact_separatists_northymbre	placeholder	true
factions_senator_text_gain_1_vik_fact_breifne	%n of %n Nobles	true
factions_clan_summary_name_when_shogun_vik_fact_djurby	placeholder	true
factions_clan_summary_name_when_shogun_vik_fact_cerneu	placeholder	true
factions_clan_summary_name_vik_fact_rebels_irish	placeholder	true
factions_senator_text_gain_n_vik_fact_separatists_irish	%n of %n Nobles	true
factions_senator_text_gain_1_vik_fact_separatists_irish	%n of %n Nobles	true
factions_defend_desc_vik_fact_west_seaxe	You are defending against West Seaxe	true
factions_attack_desc_vik_fact_connacht	You are attacking Connacht	true
factions_senator_text_gain_n_vik_fact_separatists_welsh	%n of %n Nobles	true
factions_senator_text_gain_1_vik_fact_separatists_welsh	%n of %n Nobles	true
factions_attack_desc_vik_fact_dorsaete	You are attacking Dorsaete	true
factions_screen_name_vik_fact_east_seaxe	East Seaxe	true
factions_clan_summary_name_vik_fact_rebels_welsh	placeholder	true
factions_senator_text_gain_1_vik_fact_northymbre	%n of %n Nobles	true
factions_senator_text_lose_1_vik_fact_brechinauc	%n of %n Nobles	true
factions_clan_summary_name_vik_fact_powis	placeholder	true
factions_clan_summary_name_vik_fact_ulaid	placeholder	true
factions_senator_text_lose_1_vik_fact_separatists_dyflin	%n of %n Nobles	true
factions_attack_desc_vik_fact_northleode_usurpers	You are attacking Northanhymbra Usurpers	true
factions_screen_name_vik_fact_northleode_usurpers	Northanhymbra Usurpers	true
factions_senator_text_lose_n_vik_fact_separatists_dyflin	%n of %n Nobles	true
factions_senator_text_lose_n_vik_fact_brechinauc	%n of %n Nobles	true
factions_senator_text_gain_n_vik_fact_northymbre	%n of %n Nobles	true
factions_senator_text_lose_1_vik_fact_separatists_gwined	%n of %n Nobles	true
factions_senator_text_lose_n_vik_fact_separatists_gwined	%n of %n Nobles	true
factions_senator_text_n_out_of_n_vik_fact_separatists_northymbre	%n of %n Nobles	true
factions_senator_text_lose_1_vik_fact_breifne	%n of %n Nobles	true
factions_senator_text_n_out_of_n_vik_fact_cerneu	%n of %n Nobles	true
factions_clan_summary_name_when_shogun_vik_fact_hylrborg	placeholder	true
factions_senator_text_n_out_of_n_vik_fact_djurby	%n of %n Nobles	true
factions_defend_desc_vik_fact_tuadmuma	You are defending against Tuadmuma	true
factions_screen_name_vik_fact_connacht	Connacht	true
factions_screen_adjective_vik_fact_dyfet	Dewet	true
factions_screen_name_vik_fact_dorsaete	Dorsaete	true
factions_screen_name_when_shogun_vik_fact_separatists_west_seaxe	placeholder	true
factions_clan_summary_name_vik_fact_brega	placeholder	true
factions_screen_adjective_vik_fact_wicing	Wicing	true
factions_senator_text_gain_1_vik_fact_seisilwig_usurpers	%n of %n Nobles	true
factions_screen_name_when_shogun_vik_fact_iarmuma	placeholder	true
factions_screen_name_when_rebels_vik_fact_breifne	Breifne Rebels	true
factions_screen_name_vik_fact_gliwissig	Gliwissig	true
factions_senator_text_gain_n_vik_fact_seisilwig_usurpers	%n of %n Nobles	true
factions_senator_text_lose_1_vik_fact_strat_clut	%n of %n Nobles	true
factions_clan_summary_name_when_shogun_vik_fact_defena	placeholder	true
factions_clan_summary_name_when_shogun_vik_fact_nordmann	placeholder	true
factions_clan_summary_name_when_shogun_vik_fact_caisil	placeholder	true
factions_defend_desc_vik_fact_dubgaill	You are defending against Dubgaill	true
factions_attack_desc_vik_fact_orkneyar	You are attacking Orkneyar	true
factions_attack_desc_vik_fact_east_seaxe	You are attacking East Seaxe	true
factions_screen_adjective_vik_fact_brega	Brega	true
factions_senator_text_lose_n_vik_fact_strat_clut	%n of %n Nobles	true
factions_senator_text_lose_1_vik_fact_hellirborg	%n of %n Nobles	true
factions_attack_desc_vik_fact_separatists_english	You are attacking English Usurpers	true
factions_clan_summary_name_vik_fact_dyfet	placeholder	true
factions_screen_name_vik_fact_separatists_english	English Usurpers	true
factions_senator_text_n_out_of_n_vik_fact_laigin	%n of %n Nobles	true
factions_clan_summary_name_vik_fact_gallgoidel	placeholder	true
factions_clan_summary_name_when_shogun_att_fact_yellow	placeholder	true
factions_screen_name_vik_fact_grantebru	Grantebru	true
factions_senator_text_lose_n_vik_fact_hellirborg	%n of %n Nobles	true
factions_clan_summary_name_when_shogun_vik_fact_hwicce	placeholder	true
factions_screen_name_vik_fact_sudreyar	Sudreyar	true
factions_senator_text_gain_1_vik_fact_brechinauc	%n of %n Nobles	true
factions_senator_text_lose_1_vik_fact_northymbre	%n of %n Nobles	true
factions_senator_text_gain_1_vik_fact_separatists_dyflin	%n of %n Nobles	true
factions_clan_summary_name_vik_fact_northleode	placeholder	true
factions_attack_desc_vik_fact_airgialla	You are attacking Airgialla	true
factions_senator_text_gain_n_vik_fact_separatists_dyflin	%n of %n Nobles	true
factions_senator_text_lose_n_vik_fact_northymbre	%n of %n Nobles	true
factions_senator_text_gain_n_vik_fact_brechinauc	%n of %n Nobles	true
factions_screen_adjective_vik_fact_separatists_circenn	Circenn Usurpers	true
factions_senator_text_n_out_of_n_vik_fact_gwined	%n of %n Nobles	true
factions_screen_adjective_vik_fact_hellirborg_usurpers	Hellirborg	true
factions_attack_desc_vik_fact_tuadmuma	You are attacking Tuadmuma	true
factions_screen_name_when_shogun_vik_fact_desmuma	placeholder	true
factions_senator_text_n_out_of_n_vik_fact_jorvik	%n of %n Nobles	true
factions_clan_summary_name_when_shogun_vik_fact_haeden	placeholder	true
factions_attack_desc_vik_fact_athfochla	You are attacking Athfochla	true
factions_clan_summary_name_when_shogun_vik_fact_dyflin	placeholder	true
factions_screen_name_vik_fact_seisilwig	Seisilwig	true
factions_defend_desc_vik_fact_finngaill	You are defending against Finngaill	true
factions_senator_text_n_out_of_n_vik_fact_rebels_english	%n of %n Nobles	true
factions_senator_text_lose_n_vik_fact_separatists_irish	%n of %n Nobles	true
factions_senator_text_lose_1_vik_fact_separatists_irish	%n of %n Nobles	true
factions_senator_text_lose_n_vik_fact_separatists_welsh	%n of %n Nobles	true
factions_senator_text_lose_1_vik_fact_separatists_welsh	%n of %n Nobles	true
factions_defend_desc_att_fact_red	Red	true
factions_clan_summary_name_when_shogun_vik_fact_mierce	placeholder	true
factions_senator_text_gain_1_vik_fact_osraige	%n of %n Nobles	true
factions_attack_desc_vik_fact_normaunds	You are attacking Normaunds	true
factions_senator_text_n_out_of_n_vik_fact_separatists_strat_clut	%n of %n Nobles	true
factions_attack_desc_vik_fact_dubgaill	You are attacking Dubgaill	true
factions_screen_name_vik_fact_myrrborg	Myrrborg	true
factions_defend_desc_vik_fact_orkneyar	You are defending against Orkneyar	true
factions_screen_name_when_shogun_vik_fact_separatists_east_engle	placeholder	true
factions_defend_desc_vik_fact_heimiliborg	You are defending against Heimiliborg	true
factions_senator_text_gain_1_vik_fact_separatists_mierce	%n of %n Nobles	true
factions_screen_name_when_shogun_vik_fact_caisil_usurpers	placeholder	true
factions_screen_name_when_shogun_vik_fact_rebels_scottish	placeholder	true
factions_screen_name_when_shogun_vik_fact_aileach	placeholder	true
factions_senator_text_gain_n_vik_fact_separatists_mierce	%n of %n Nobles	true
factions_senator_text_gain_1_vik_fact_bandits	%n of %n Nobles	true
factions_screen_name_vik_fact_hlymrekr_usurpers	Hlymrekr Usurpers	true
